それいけ!アンパンマン	浅井清己,浅川悠,荒川美穂,有島モユ,伊瀬茉莉也,井上喜久子,岩男潤子,榎本温子,大谷育江,大本眞基子,岡村明美,沖佳苗,折笠富美子,甲斐田裕子,笠原弘子,金田朋子,茅野愛衣,川田妙子,神田朱未,橘田いずみ,工藤晴香,桑島法子,小暮英麻,小西風優,小林由美子,今野宏美,坂本真綾,佐藤聡美,沢城みゆき,三瓶由布子,島本須美,鈴木真仁,鈴木美咲,高山みなみ,竹内順子,田中真弓,丹下桜,千葉紗子,千葉千恵巳,寺崎裕香,豊嶋真千子,中島沙樹,長嶋はるか,中原麻衣,中村知子,根谷美智子,野沢雅子,能登麻美子,早見沙織,潘恵子,氷上恭子,久川綾,日高のり子,平野綾,福井裕佳梨,福圓美里,本多知恵子,牧口真幸,松本梨香,三石琴乃,皆川純子,皆口裕子,南央美,山崎和佳奈,山田栄子,悠木碧,横山智佐,渡辺久美子
地獄少女	浅野真澄,阿澄佳奈,新井里美,井澤詩織,伊瀬茉莉也,今井麻美,岩男潤子,植田佳奈,大浦冬華,大谷育江,岡村明美,沖佳苗,小野涼子,折笠富美子,甲斐田裕子,門脇舞以,神田朱未,橘田いずみ,釘宮理恵,桑島法子,桑谷夏子,後藤邑子,寿美菜子,小林ゆう,酒井香奈子,阪田佳代,佐藤聡美,沢城みゆき,三瓶由布子,下屋則子,島本須美,清水愛,清水香里,真堂圭,高垣彩陽,千葉紗子,恒松あゆみ,友永朱音,生天目仁美,新名彩乃,根本圭子,根谷美智子,能登麻美子,久川綾,廣田詩夢,広橋涼,福圓美里,藤田咲,藤村歩,本田貴子,松岡由貴,水樹奈々,水沢史絵,水野愛日,皆川純子,皆口裕子,南央美,望月久代,森永理科,悠木碧,ゆかな,力丸乃りこ
ドラえもん_(2005年のテレビアニメ)	浅川悠,飯塚雅弓,井上喜久子,大本眞基子,大山のぶ代,岡村明美,折笠富美子,甲斐田ゆき,勝田詩織,門脇舞以,金田朋子,金元寿子,川田妙子,神田朱未,釘宮理恵,桑島法子,桑谷夏子,後藤邑子,小林由美子,今野宏美,櫻井智,三瓶由布子,新谷良子,高山みなみ,田口宏子,生天目仁美,沼倉愛美,根谷美智子,原田ひとみ,久川綾,廣田詩夢,福圓美里,堀江由衣,本多知恵子,松岡由貴,水田わさび,三石琴乃,皆川純子,皆口裕子,南央美,山崎バニラ,渡辺久美子
銀魂_(アニメ)	新井里美,植田佳奈,榎本温子,遠藤綾,折笠富美子,甲斐田裕子,鹿野優以,神田理江,釘宮理恵,小清水亜美,後藤邑子,小林ゆう,櫻井智,沢城みゆき,三瓶由布子,下屋則子,島本須美,清水愛,下田麻美,進藤尚美,高森奈津美,滝田樹里,竹内順子,田村ゆかり,恒松あゆみ,長嶋はるか,仁後真耶子,沼倉愛美,根本圭子,能登麻美子,早水リサ,原田ひとみ,広橋涼,本田貴子,牧口真幸,又吉愛,南央美,三宅華也,ゆかな,米澤円
BLEACH_(アニメ)	浅井清己,井ノ上奈々,大浦冬華,大亀あすか,緒方恵美,折笠富美子,甲斐田裕子,金田朋子,金元寿子,川田妙子,神田朱未,釘宮理恵,桑島法子,小林ゆう,佐久間紅美,真田アサミ,下屋則子,島本須美,真堂圭,園崎未恵,綱掛裕美,中島沙樹,生天目仁美,野田順子,能登麻美子,長谷優里奈,早水リサ,原田ひとみ,久川綾,廣田詩夢,藤田咲,藤村歩,本田貴子,松岡由貴,水原薫,三宅華也,望月久代,ゆかな
ゲゲゲの鬼太郎_(アニメ)	浅野真澄,池澤春菜,井上喜久子,大谷育江,大本眞基子,岡村明美,折笠富美子,加藤英美里,金田朋子,鹿野優以,神田朱未,釘宮理恵,桑島法子,小林由美子,今野宏美,佐藤聡美,島本須美,進藤尚美,鈴木真仁,園崎未恵,高山みなみ,田中真弓,丹下桜,豊嶋真千子,中原麻衣,生天目仁美,根谷美智子,野沢雅子,野田順子,潘恵子,久川綾,広橋涼,福圓美里,牧野由依,山崎和佳奈,山田栄子,ゆかな
SKET_DANCE	赤崎千夏,浅倉杏美,新井里美,榎本温子,遠藤綾,折笠富美子,加藤英美里,茅野愛衣,釘宮理恵,工藤晴香,後藤邑子,小林ゆう,佐倉綾音,佐藤聡美,清水愛,高垣彩陽,高森奈津美,竹達彩奈,田村ゆかり,丹下桜,津田美波,沼倉愛美,早見沙織,原由実,氷上恭子,久川綾,藤井ゆきよ,藤田咲,牧口真幸,松来未祐,水原薫,皆川純子,皆口裕子
しゅごキャラ!	明坂聡美,浅井清己,阿澄佳奈,新井里美,井口裕香,井上喜久子,遠藤綾,小倉唯,加藤英美里,加藤奈々絵,門脇舞以,神田朱未,釘宮理恵,今野宏美,佐藤聡美,沢城みゆき,下屋則子,清水愛,進藤尚美,仙台エリ,千葉紗子,永田依子,中原麻衣,中村知子,根本圭子,野沢雅子,広橋涼,藤村歩,三上枝織,水樹奈々,皆川純子,南央美,三宅華也
とっとこハム太郎_(アニメ)	浅川悠,浅野真澄,新井里美,池澤春菜,遠藤綾,大浦冬華,大谷育江,おみむらまゆこ,折笠富美子,甲斐田裕子,加藤英美里,川田妙子,釘宮理恵,小林由美子,下屋則子,清水愛,田口宏子,竹内順子,千葉紗子,千葉千恵巳,恒松あゆみ,生天目仁美,根本圭子,野沢雅子,本田貴子,本名陽子,松岡由貴,水田わさび,皆川純子,三宅華也,望月久代,渡辺久美子
犬夜叉	井上喜久子,今井麻美,岩男潤子,大谷育江,大本眞基子,折笠富美子,加藤奈々絵,金田朋子,釘宮理恵,桑島法子,桑谷夏子,小暮英麻,小林ゆう,小林由美子,齋藤彩夏,阪田佳代,真田アサミ,清水香里,高橋理恵子,田口宏子,中川亜紀子,生天目仁美,野田順子,能登麻美子,日高のり子,水橋かおり,皆口裕子,三宅華也,山崎和佳奈,ゆかな,渡辺久美子
美少女戦士セーラームーン_(アニメ)	伊瀬茉莉也,井上喜久子,大久保瑠美,大谷育江,大本眞基子,緒方恵美,沖佳苗,川田妙子,桑島法子,三瓶由布子,島本須美,高垣彩陽,竹達彩奈,田中真弓,丹下桜,友永朱音,豊嶋真千子,根谷美智子,野田順子,潘恵子,日笠陽子,久川綾,本多知恵子,三石琴乃,皆口裕子,南央美,山崎和佳奈,山田栄子,山本麻里安,悠木碧,渡辺久美子
のらみみ	浅川悠,榎本温子,岡村明美,折笠富美子,加藤英美里,加藤奈々絵,鹿野優以,川田妙子,神田朱未,小林ゆう,小林由美子,今野宏美,真田アサミ,沢城みゆき,三瓶由布子,島本須美,志村由美,新谷良子,高垣彩陽,千葉千恵巳,綱掛裕美,根谷美智子,平田宏美,広橋涼,福圓美里,藤村歩,本名陽子,又吉愛,皆川純子,三宅華也
CLANNAD_(ゲーム)	有島モユ,井上喜久子,榎本温子,大浦冬華,鹿野優以,神田朱未,菊地ゆうみ,桑島法子,桑谷夏子,坂本梓馬,佐久間紅美,三瓶由布子,志村由美,田村睦心,田村ゆかり,中島沙樹,中原麻衣,中村知子,能登麻美子,早見沙織,早水リサ,日笠陽子,広橋涼,藤村歩,本多陽子,水沢史絵,皆口裕子,森永理科
ARIA_(漫画)	阿澄佳奈,飯塚雅弓,稲村優奈,内山夕実,大浦冬華,岡村明美,折笠富美子,加藤英美里,茅野愛衣,儀武ゆう子,桑島法子,小林由美子,三瓶由布子,中原麻衣,能登麻美子,葉月絵理乃,花澤香菜,早水リサ,広橋涼,藤村歩,牧口真幸,牧野由依,又吉愛,松来未祐,水沢史絵,水橋かおり,皆川純子,吉田聖子
マリア様がみてる_(アニメ)	浅野真澄,池澤春菜,植田佳奈,大浦冬華,沖佳苗,甲斐田裕子,釘宮理恵,桑谷夏子,小清水亜美,寿美菜子,小林ゆう,佐藤聡美,沢城みゆき,下屋則子,清水香里,真堂圭,高垣彩陽,高山みなみ,竹達彩奈,中川亜紀子,生天目仁美,能登麻美子,日笠陽子,又吉愛,三石琴乃,皆川純子,りの
SDガンダム_GGENERATION	浅川悠,浅野真澄,新井里美,井上喜久子,遠藤綾,小笠原亜里沙,折笠富美子,釘宮理恵,桑島法子,坂本真綾,進藤尚美,園崎未恵,高垣彩陽,高山みなみ,滝田樹里,仁後真耶子,根谷美智子,早見沙織,潘恵子,藤村歩,本多知恵子,本名陽子,松本梨香,ゆかな,横山智佐,渡辺久美子
メジャー_(アニメ)	井上喜久子,植田佳奈,榎本温子,遠藤綾,大浦冬華,金田朋子,釘宮理恵,小林由美子,櫻井浩美,沢城みゆき,竹内順子,茅原実里,恒松あゆみ,根本圭子,野田順子,能登麻美子,日高のり子,日高里菜,藤村歩,本多陽子,牧口真幸,水沢史絵,水田わさび,三宅華也,米澤円
スレイヤーズ_(アニメ)	飯塚雅弓,伊瀬茉莉也,井上喜久子,大谷育江,沖佳苗,橘田いずみ,桑島法子,小林由美子,佐久間紅美,三瓶由布子,新谷良子,進藤尚美,鈴木真仁,高垣彩陽,高山みなみ,田中真弓,中原麻衣,生天目仁美,野田順子,原田ひとみ,氷上恭子,久川綾,三石琴乃,山本麻里安,渡辺久美子
聖痕のクェイサー	明坂聡美,浅川悠,内田真礼,大浦冬華,小野涼子,櫻井浩美,三瓶由布子,清水愛,高垣彩陽,巽悠衣子,田村ゆかり,茅原実里,永田依子,中原麻衣,中村知子,生天目仁美,花澤香菜,早水リサ,原田ひとみ,日笠陽子,平野綾,藤村歩,水原薫,皆川純子,山本希望
夢色パティシエール	荒浪和沙,井口裕香,伊瀬茉莉也,井上喜久子,今井麻美,内田彩,小倉唯,加藤英美里,桑谷夏子,寿美菜子,佐藤聡美,高垣彩陽,高森奈津美,竹内美優,竹達彩奈,茅原実里,永田依子,中村知子,野沢雅子,葉山いくみ,日笠陽子,平井理子,廣田詩夢,藤村歩,悠木碧
ああっ女神さまっ	井上喜久子,大谷育江,緒方恵美,岡村明美,加藤英美里,神田理江,真田アサミ,下屋則子,進藤尚美,千葉千恵巳,恒松あゆみ,根本圭子,能登麻美子,久川綾,日高のり子,堀江由衣,本多知恵子,本名陽子,牧口真幸,松来未祐,三宅華也,悠木碧,ゆかな,米澤円
エレメンタル_ジェレイド	阿澄佳奈,飯塚雅弓,内田彩,大谷育江,緒方恵美,岡村明美,神田朱未,釘宮理恵,桑島法子,桑谷夏子,小林由美子,佐久間紅美,佐藤聡美,真田アサミ,下田麻美,滝田樹里,田口宏子,田村ゆかり,綱掛裕美,沼倉愛美,水樹奈々,三石琴乃,南央美,渡辺久美子
咲-Saki-	浅野真澄,植田佳奈,内山夕実,大橋歩夕,甲斐田裕子,釘宮理恵,桑谷夏子,小清水亜美,小林ゆう,三瓶由布子,清水愛,新谷良子,茅原実里,東山奈央,永田依子,中原麻衣,花澤香菜,藤田咲,堀江由衣,MAKO,又吉愛,三上枝織,森永理科,悠木碧
XXXHOLiC	飯塚雅弓,加藤英美里,金田朋子,桑谷夏子,小林由美子,阪田佳代,佐久間紅美,佐藤聡美,島本須美,仙台エリ,園崎未恵,高橋理恵子,田村ゆかり,千葉紗子,野田順子,能登麻美子,長谷川明子,氷上恭子,日高里菜,本名陽子,牧口真幸,牧野由依,水沢史絵,望月久代
灼眼のシャナ_(アニメ)	浅野真澄,新井里美,井口裕香,伊瀬茉莉也,大浦冬華,岡村明美,加藤奈々絵,茅野愛衣,釘宮理恵,桑島法子,小林由美子,櫻井智,三瓶由布子,高森奈津美,田村睦心,田村ゆかり,生天目仁美,能登麻美子,葉山いくみ,早見沙織,藤村歩,本多陽子,皆川純子
ツバサ-RESERVoir_CHRoNiCLE-	浅川悠,遠藤綾,甲斐田裕子,笠原弘子,加藤英美里,神田理江,小林由美子,坂本真綾,下屋則子,島本須美,清水愛,高山みなみ,千葉紗子,千葉千恵巳,恒松あゆみ,中川亜紀子,野沢雅子,久川綾,本田貴子,本多知恵子,牧野由依,皆川純子,望月久代
D.Gray-man	榎本温子,小笠原亜里沙,岡村明美,甲斐田裕子,川田妙子,桑島法子,國立幸,小林由美子,坂本真綾,三瓶由布子,下屋則子,清水愛,高山みなみ,千葉紗子,恒松あゆみ,仲西環,根本圭子,堀江由衣,本田貴子,松岡由貴,皆川純子,山本麻里安,米澤円
FAIRY_TAIL	新井里美,井口裕香,井澤詩織,伊瀬茉莉也,大浦冬華,大亀あすか,大久保瑠美,小野涼子,釘宮理恵,小林ゆう,櫻井浩美,佐藤聡美,沢城みゆき,進藤尚美,鈴木美咲,中原麻衣,能登麻美子,葉山いくみ,平野綾,藤井ゆきよ,堀江由衣,MAKO,松嵜麗
金色のガッシュ!!	秋谷智子,浅川悠,池澤春菜,壱智村小真,大谷育江,岡村明美,折笠富美子,甲斐田ゆき,川田妙子,釘宮理恵,桑島法子,小林由美子,齋藤彩夏,サエキトモ,高山みなみ,竹内順子,千葉千恵巳,豊嶋真千子,松来未祐,水田わさび,三石琴乃,山崎和佳奈,渡辺久美子
ハートキャッチプリキュア!	伊瀬茉莉也,井上喜久子,沖佳苗,折笠富美子,金田朋子,川田妙子,桑島法子,小清水亜美,小林由美子,三瓶由布子,下屋則子,鈴木真仁,仙台エリ,園崎未恵,高山みなみ,久川綾,藤井ゆきよ,水樹奈々,水沢史絵,皆口裕子,山崎和佳奈,吉田聖子,吉田仁美
金田一少年の事件簿_(アニメ)	飯塚雅弓,池澤春菜,岩男潤子,大谷育江,岡村明美,折笠富美子,笠原弘子,島本須美,清水香里,高橋理恵子,田中真弓,天神有海,中川亜紀子,野沢雅子,潘恵子,久川綾,日高のり子,松本梨香,水田わさび,三石琴乃,皆口裕子,山崎和佳奈
絶対可憐チルドレン_(アニメ)	浅野真澄,井上喜久子,大浦冬華,折笠富美子,加藤英美里,釘宮理恵,小清水亜美,小林由美子,下屋則子,清水愛,真堂圭,千葉紗子,恒松あゆみ,中島沙樹,中原麻衣,生天目仁美,平野綾,藤村歩,牧口真幸,松岡由貴,皆川純子,ゆかな
のだめカンタービレ	新井里美,大浦冬華,小野涼子,折笠富美子,釘宮理恵,工藤晴香,佐久間紅美,佐藤聡美,沢城みゆき,進藤尚美,滝田樹里,田村睦心,千葉紗子,永田依子,生天目仁美,能登麻美子,藤村歩,本田貴子,本多陽子,牧野由依,三石琴乃,米澤円
NARUTO_-ナルト-_(アニメ)	浅井清己,浅野真澄,大谷育江,川田妙子,小暮英麻,後藤邑子,小林由美子,坂本真綾,下屋則子,竹内順子,田村ゆかり,恒松あゆみ,根本圭子,野沢雅子,能登麻美子,早水リサ,氷上恭子,本田貴子,松来未祐,松本梨香,水樹奈々,皆川純子
うみねこのなく頃に	井澤詩織,井上喜久子,大浦冬華,甲斐田ゆき,釘宮理恵,桑谷夏子,小清水亜美,小林ゆう,沢城みゆき,島本須美,真堂圭,仙台エリ,田村ゆかり,茅原実里,新名彩乃,根谷美智子,葉山いくみ,日笠陽子,廣田詩夢,堀江由衣,吉田聖子,米澤円
ハヤテのごとく!_(アニメ)	浅野真澄,阿澄佳奈,植田佳奈,遠藤綾,加藤英美里,加藤奈々絵,金田朋子,儀武ゆう子,釘宮理恵,後藤邑子,小林由美子,清水愛,新谷良子,田村ゆかり,恒松あゆみ,中島沙樹,生天目仁美,日笠陽子,藤村歩,堀江由衣,松来未祐,皆口裕子
とある魔術の禁書目録	阿澄佳奈,新井里美,井口裕香,井澤詩織,伊瀬茉莉也,井上喜久子,遠藤綾,甲斐田裕子,茅野愛衣,釘宮理恵,桑島法子,寿美菜子,櫻井浩美,竹達彩奈,寺崎裕香,能登麻美子,日高里菜,福圓美里,藤田咲,藤村歩,本名陽子,吉田仁美
ヴァイスクロイツ	浅井清己,飯塚雅弓,井上喜久子,今井麻美,岡村明美,折笠富美子,笠原弘子,神田理江,桑島法子,桑谷夏子,清水香里,田村ゆかり,綱掛裕美,豊嶋真千子,根谷美智子,早水リサ,氷上恭子,久川綾,堀江由衣,三石琴乃,南央美
ソウルイーター	沖佳苗,小見川千明,甲斐田裕子,加藤英美里,桑島法子,小林由美子,齋藤彩夏,坂本真綾,沢城みゆき,竹内順子,根谷美智子,野田順子,能登麻美子,福圓美里,本田貴子,本多知恵子,牧口真幸,牧野由依,三石琴乃,望月久代,ゆかな
Canvas2	浅野真澄,阿澄佳奈,井口裕香,榎本温子,門脇舞以,神田朱未,釘宮理恵,桑谷夏子,小清水亜美,小林ゆう,阪田佳代,三瓶由布子,滝田樹里,綱掛裕美,中島沙樹,生天目仁美,能登麻美子,長谷優里奈,平野綾,堀江由衣,水樹奈々
乃木坂春香の秘密	浅倉杏美,井口裕香,井上喜久子,植田佳奈,釘宮理恵,清水香里,永田依子,中村知子,生天目仁美,能登麻美子,花澤香菜,葉山いくみ,日笠陽子,久川綾,日高里菜,松来未祐,松嵜麗,水原薫,森谷里美,悠木碧
六門天外モンコレナイト	池澤春菜,岩男潤子,釘宮理恵,小暮英麻,小林由美子,サエキトモ,真田アサミ,沢城みゆき,清水香里,竹内順子,田村ゆかり,千葉千恵巳,中島沙樹,氷上恭子,堀江由衣,松本梨香,水橋かおり,南央美,山本麻里安,渡辺久美子
これはゾンビですか?	新井里美,金田朋子,金元寿子,合田彩,下屋則子,清水愛,田村ゆかり,丹下桜,月宮みどり,生天目仁美,能登麻美子,野水伊織,日笠陽子,日高のり子,本多真梨子,松岡由貴,水原薫,三石琴乃,美名,皆口裕子
デジモンクロスウォーズ	浅野真澄,遠藤綾,大浦冬華,大本眞基子,岡村明美,沖佳苗,金田朋子,桑島法子,小林ゆう,今野宏美,真田アサミ,高山みなみ,野田順子,原嶋あかり,藤井ゆきよ,三上枝織,水橋かおり,皆川純子,山崎和佳奈,渡辺久美子
セキレイ_(漫画)	明坂聡美,阿澄佳奈,井口裕香,植田佳奈,遠藤綾,甲斐田裕子,甲斐田ゆき,金元寿子,小林ゆう,高垣彩陽,田村ゆかり,中村知子,生天目仁美,根谷美智子,花澤香菜,早見沙織,日笠陽子,平田宏美,藤村歩,ゆかな
わがまま☆フェアリー_ミルモでポン!	おみむらまゆこ,川田妙子,神田理江,釘宮理恵,下屋則子,清水愛,千葉千恵巳,恒松あゆみ,中原麻衣,生天目仁美,南里侑香,根本圭子,野沢雅子,野田順子,早水リサ,松来未祐,水田わさび,水橋かおり,三宅華也,望月久代
ふたりはプリキュア	飯塚雅弓,池澤春菜,壱智村小真,岡村明美,小野涼子,折笠富美子,川田妙子,小清水亜美,沢城みゆき,仙台エリ,中川亜紀子,生天目仁美,野沢雅子,本名陽子,松岡由貴,水沢史絵,水田わさび,ゆかな,吉田仁美,渡辺久美子
まるマシリーズ	浅川悠,折笠富美子,甲斐田ゆき,加藤英美里,國立幸,後藤邑子,櫻井浩美,三瓶由布子,下屋則子,島本須美,高山みなみ,田口宏子,恒松あゆみ,仲西環,根本圭子,本田貴子,本多陽子,三宅華也,山崎和佳奈,ゆかな
ジュエルペット_てぃんくる☆	井口裕香,甲斐田ゆき,金元寿子,釘宮理恵,齋藤彩夏,酒井香奈子,沢城みゆき,清水愛,下田麻美,高森奈津美,竹内順子,竹達彩奈,沼倉愛美,平野綾,堀江由衣,MAKO,松嵜麗,皆川純子,悠木碧,吉田仁美
クイーンズブレイド_(アニメ)	井口裕香,内山夕実,甲斐田裕子,甲斐田ゆき,鹿野優以,釘宮理恵,後藤邑子,齋藤彩夏,佐藤聡美,竹内美優,竹達彩奈,中村知子,生天目仁美,能登麻美子,平野綾,藤村歩,本田貴子,本多陽子,水橋かおり
探偵学園Q	浅井清己,緒方恵美,折笠富美子,金田朋子,桑島法子,桑谷夏子,今野宏美,佐久間紅美,真田アサミ,中川亜紀子,中原麻衣,野沢雅子,野田順子,久川綾,日高のり子,堀江由衣,本田貴子,三石琴乃,ゆかな
オオカミさんシリーズ	新井里美,井口裕香,井澤詩織,内田真礼,小野涼子,甲斐田裕子,金元寿子,釘宮理恵,寿美菜子,佐倉綾音,佐藤聡美,巽悠衣子,中原麻衣,生天目仁美,早見沙織,福井裕佳梨,堀江由衣,松嵜麗,水原薫
ミニスカ宇宙海賊	赤崎千夏,伊瀬茉莉也,内田真礼,小見川千明,甲斐田裕子,金元寿子,茅野愛衣,小松未可子,佐藤聡美,高森奈津美,巽悠衣子,西明日香,花澤香菜,早見沙織,日笠陽子,堀江由衣,水原薫,三森すずこ,安野希世乃
伝説の勇者の伝説	伊瀬茉莉也,植田佳奈,遠藤綾,大浦冬華,沖佳苗,儀武ゆう子,寿美菜子,沢城みゆき,高垣彩陽,高森奈津美,竹達彩奈,千葉紗子,早見沙織,久川綾,日高里菜,藤田咲,水橋かおり,村田知沙,森谷里美
逮捕しちゃうぞ_(アニメ)	飯塚雅弓,池澤春菜,植田佳奈,大浦冬華,大本眞基子,岡村明美,小野涼子,折笠富美子,齋藤彩夏,佐久間紅美,真堂圭,進藤尚美,丹下桜,根谷美智子,藤村歩,松本梨香,水沢史絵,南央美,渡辺久美子
けいおん!	赤崎千夏,浅川悠,大亀あすか,大久保瑠美,寿美菜子,佐藤聡美,真田アサミ,仙台エリ,竹達彩奈,巽悠衣子,寺本來可,永田依子,中村知子,西明日香,日笠陽子,藤東知夏,牧口真幸,MAKO,米澤円
神曲奏界ポリフォニカ	浅井清己,阿澄佳奈,井口裕香,遠藤綾,小野涼子,門脇舞以,神田朱未,佐久間紅美,茅原実里,生天目仁美,野田順子,能登麻美子,氷上恭子,平井理子,藤村歩,水樹奈々,水沢史絵,悠木碧,吉田聖子
夏目友人帳	大浦冬華,岡村明美,折笠富美子,加藤奈々絵,桑島法子,沢城みゆき,高垣彩陽,竹内順子,寺崎裕香,生天目仁美,能登麻美子,広橋涼,藤村歩,本田貴子,本多知恵子,皆川純子,持月玲依,森谷里美,悠木碧
ギャラクシーエンジェル_(アニメ)	井口裕香,井上喜久子,今井麻美,榎本温子,川田妙子,釘宮理恵,サエキトモ,真田アサミ,沢城みゆき,三瓶由布子,下屋則子,清水愛,新谷良子,田村ゆかり,能登麻美子,松岡由貴,水橋かおり,桃井はるこ,吉住梢
とある科学の超電磁砲	浅野真澄,新井里美,井口裕香,植田佳奈,遠藤綾,大浦冬華,甲斐田裕子,橘田いずみ,寿美菜子,佐藤聡美,竹達彩奈,田村ゆかり,永田依子,生天目仁美,能登麻美子,花澤香菜,福圓美里,皆川純子,悠木碧
るろうに剣心_-明治剣客浪漫譚-	岩男潤子,大谷育江,緒方恵美,甲斐田ゆき,笠原弘子,川田妙子,櫻井智,三瓶由布子,島本須美,清水香里,鈴木真仁,高山みなみ,竹内順子,田中真弓,根谷美智子,日高のり子,本多知恵子,三宅華也,横山智佐
境界線上のホライゾン	浅野真澄,大橋歩夕,小清水亜美,寿美菜子,小林ゆう,沢城みゆき,三瓶由布子,清水愛,新谷良子,真堂圭,田村睦心,茅原実里,東山奈央,友永朱音,中原麻衣,新田恵海,又吉愛,森永理科,悠木碧
ぬらりひょんの孫	浅川悠,阿澄佳奈,新井里美,井澤詩織,井上喜久子,井ノ上奈々,折笠富美子,桑島法子,國立幸,小清水亜美,真田アサミ,高森奈津美,竹内順子,根谷美智子,能登麻美子,日笠陽子,平野綾,堀江由衣
おとぎ銃士_赤ずきん	井口裕香,壱智村小真,大浦冬華,小野涼子,儀武ゆう子,釘宮理恵,桑島法子,小林ゆう,小林由美子,坂本梓馬,沢城みゆき,三瓶由布子,清水香里,田村ゆかり,松岡由貴,水沢史絵,皆口裕子,ゆかな
爆丸バトルブローラーズ	阿澄佳奈,井口裕香,大浦冬華,小野涼子,加藤英美里,金田朋子,小林ゆう,真田アサミ,沢城みゆき,進藤尚美,仙台エリ,滝田樹里,津田美波,恒松あゆみ,能登麻美子,原田ひとみ,広橋涼,藤村歩
おジャ魔女どれみ	秋谷智子,浅井清己,壱智村小真,井上喜久子,大谷育江,岡村明美,甲斐田ゆき,川田妙子,サエキトモ,島本須美,竹内順子,千葉千恵巳,寺本來可,天神有海,能登麻美子,松岡由貴,松来未祐,渡辺久美子
東京ミュウミュウ	明坂聡美,浅井清己,緒方恵美,岡村明美,折笠富美子,金田朋子,川田妙子,神田朱未,佐久間紅美,高橋理恵子,中川亜紀子,中島沙樹,根谷美智子,野田順子,本田貴子,MAKO,皆川純子,望月久代
快盗天使ツインエンジェルシリーズ	浅川悠,浅野真澄,井口裕香,井ノ上奈々,植田佳奈,釘宮理恵,合田彩,沢城みゆき,新谷良子,巽悠衣子,田村ゆかり,中原麻衣,西明日香,能登麻美子,野水伊織,藤村歩,堀江由衣,本多真梨子
狂乱家族日記	小野涼子,甲斐田ゆき,神田朱未,釘宮理恵,後藤邑子,寿美菜子,下屋則子,清水愛,千葉千恵巳,中原麻衣,生天目仁美,花澤香菜,広橋涼,藤村歩,水樹奈々,水沢史絵,皆川純子,森永理科
ロックマンエグゼStream	植田佳奈,加藤奈々絵,釘宮理恵,小清水亜美,仙台エリ,千葉紗子,恒松あゆみ,中川亜紀子,生天目仁美,根本圭子,根谷美智子,能登麻美子,早水リサ,日高のり子,本多陽子,水橋かおり,三宅華也,渡辺久美子
青い花_(漫画)	明坂聡美,井口裕香,大浦冬華,沖佳苗,小野涼子,橘田いずみ,儀武ゆう子,佐藤聡美,高部あい,永田依子,中原麻衣,中村知子,能登麻美子,花澤香菜,福井裕佳梨,藤村歩,堀江由衣,MAKO
ひだまりスケッチ_(アニメ)	阿澄佳奈,磯村知美,大亀あすか,小見川千明,釘宮理恵,桑谷夏子,小清水亜美,後藤邑子,小林ゆう,阪田佳代,沢城みゆき,新谷良子,中原麻衣,根谷美智子,原田ひとみ,福圓美里,松来未祐,水橋かおり
舞-HiME	浅井清己,井上喜久子,岩男潤子,栗林みな実,沢城みゆき,清水愛,新谷良子,進藤尚美,仙台エリ,田村ゆかり,千葉紗子,中原麻衣,南里侑香,能登麻美子,氷上恭子,MAKO,松来未祐,ゆかな
あそびにいくヨ!	井口裕香,井上喜久子,金田朋子,桑谷夏子,寿美菜子,齋藤彩夏,三瓶由布子,進藤尚美,仙台エリ,高垣彩陽,田村睦心,千葉紗子,茅原実里,能登麻美子,野水伊織,花澤香菜,平田宏美,堀江由衣
たまごっち!	伊瀬茉莉也,岡村明美,加藤奈々絵,金田朋子,儀武ゆう子,釘宮理恵,桑谷夏子,三瓶由布子,真堂圭,進藤尚美,竹達彩奈,津田美波,生天目仁美,能登麻美子,早水リサ,水田わさび,三石琴乃,ゆかな
ロウきゅーぶ!	井口裕香,伊瀬茉莉也,内山夕実,大亀あすか,小倉唯,茅野愛衣,釘宮理恵,寿美菜子,佐倉綾音,佐藤聡美,田中真奈美,能登麻美子,花澤香菜,早見沙織,日笠陽子,日高里菜,持月玲依,桃井はるこ
ねぎぼうずのあさたろう	浅野真澄,大谷育江,岡村明美,金田朋子,鹿野優以,神田朱未,桑島法子,真田アサミ,進藤尚美,鈴木真仁,田中真弓,豊嶋真千子,久川綾,牧野由依,水沢史絵,南央美,ゆかな
D.C._〜ダ・カーポ〜_(アニメ)	浅井清己,浅野真澄,今井麻美,鹿野優以,神田朱未,桑谷夏子,小暮英麻,沢城みゆき,下屋則子,田村ゆかり,長谷優里奈,早水リサ,堀江由衣,松岡由貴,松来未祐,桃井はるこ,森永理科
桜蘭高校ホスト部	浅井清己,井上喜久子,大谷育江,小野涼子,門脇舞以,桑谷夏子,齋藤彩夏,阪田佳代,坂本真綾,三瓶由布子,高垣彩陽,竹内順子,田村ゆかり,根谷美智子,葉月絵理乃,久川綾,吉住梢
神様のメモ帳	伊瀬茉莉也,植田佳奈,内田真礼,遠藤綾,大浦冬華,小倉唯,茅野愛衣,寿美菜子,櫻井浩美,巽悠衣子,生天目仁美,西明日香,沼倉愛美,野水伊織,葉山いくみ,本多陽子,水原薫
ゼロの使い魔	赤崎千夏,新井里美,井口裕香,伊瀬茉莉也,井上喜久子,植田佳奈,金元寿子,茅野愛衣,釘宮理恵,桑島法子,小清水亜美,高森奈津美,田村睦心,根谷美智子,能登麻美子,平田宏美,堀江由衣
ぱにぽに	植田佳奈,折笠富美子,門脇舞以,金田朋子,阪田佳代,沢城みゆき,下屋則子,新谷良子,生天目仁美,広橋涼,堀江由衣,本名陽子,松来未祐,望月久代,山崎バニラ,山本麻里安,ゆかな
世界一初恋	井澤詩織,今井麻美,内山夕実,遠藤綾,大浦冬華,儀武ゆう子,工藤晴香,小林ゆう,田村睦心,田村ゆかり,中原麻衣,葉山いくみ,早見沙織,廣田詩夢,藤井ゆきよ,美名,皆川純子
桃華月憚	井口裕香,伊瀬茉莉也,後藤邑子,小林ゆう,齋藤彩夏,下屋則子,島本須美,清水愛,高橋理恵子,能登麻美子,早見沙織,藤村歩,水沢史絵,水橋かおり,三宅華也,森永理科,山本麻里安
きらりん☆レボリューション	浅倉杏美,井上喜久子,榎本温子,大浦冬華,おみむらまゆこ,加藤英美里,佐藤聡美,下屋則子,島本須美,恒松あゆみ,根谷美智子,野沢雅子,本田貴子,松来未祐,三宅華也,望月久代,米澤円
イタズラなKiss	浅川悠,荒浪和沙,内田彩,笠原弘子,金田朋子,桑谷夏子,後藤邑子,小林由美子,真田アサミ,沢城みゆき,高垣彩陽,田中真弓,恒松あゆみ,野田順子,早水リサ,水樹奈々,望月久代
探偵オペラ_ミルキィホームズ_(アニメ)	赤崎千夏,明坂聡美,井上喜久子,橘田いずみ,小林ゆう,沢城みゆき,新谷良子,高森奈津美,田村ゆかり,寺川愛美,徳井青空,永田依子,中原麻衣,生天目仁美,西明日香,原嶋あかり,三森すずこ
ロッテのおもちゃ!	阿澄佳奈,甲斐田裕子,釘宮理恵,後藤邑子,進藤尚美,鈴木美咲,田村ゆかり,丹下桜,寺川愛美,東山奈央,長嶋はるか,生天目仁美,広橋涼,藤村歩,堀江由衣,松来未祐,皆口裕子
だぁ!だぁ!だぁ!	池澤春菜,榎本温子,岡村明美,甲斐田裕子,後藤邑子,真田アサミ,沢城みゆき,三瓶由布子,下屋則子,千葉千恵巳,仲西環,野田順子,日高のり子,三石琴乃,皆口裕子,望月久代,ゆかな
ラストエグザイル-銀翼のファム-	小見川千明,折笠富美子,茅野愛衣,桑谷夏子,小松未可子,坂本真綾,沢城みゆき,仙台エリ,東山奈央,根谷美智子,野田順子,野水伊織,花澤香菜,本田貴子,悠木碧,ゆかな
がくえんゆーとぴあ_まなびストレート!	植田佳奈,金田朋子,鹿野優以,寿美菜子,真堂圭,高垣彩陽,茅原実里,葉月絵理乃,久川綾,平野綾,藤田咲,藤村歩,堀江由衣,本多陽子,三宅華也,森永理科
ストライクウィッチーズ	浅野真澄,大橋歩夕,門脇舞以,小清水亜美,真田アサミ,沢城みゆき,三瓶由布子,園崎未恵,千葉紗子,中村知子,花澤香菜,広橋涼,福圓美里,水橋かおり,森永理科,米澤円
魔乳秘剣帖	赤崎千夏,浅川悠,内田真礼,内山夕実,甲斐田裕子,寿美菜子,高垣彩陽,中村知子,能登麻美子,原田ひとみ,日笠陽子,広橋涼,福圓美里,松嵜麗,水原薫,吉田聖子
アイドルマスター_(アニメ)	浅倉杏美,今井麻美,内山夕実,釘宮理恵,三瓶由布子,下田麻美,滝田樹里,巽悠衣子,永田依子,仁後真耶子,沼倉愛美,長谷川明子,花澤香菜,原由実,平田宏美,松嵜麗
ロックマンエグゼBEAST	甲斐田ゆき,神田理江,下屋則子,仙台エリ,千葉紗子,根谷美智子,野沢雅子,能登麻美子,早水リサ,日高のり子,本田貴子,松岡由貴,水橋かおり,南央美,米澤円,渡辺久美子
ぼくらの	阿澄佳奈,井口裕香,大浦冬華,神田朱未,釘宮理恵,三瓶由布子,進藤尚美,千葉紗子,恒松あゆみ,能登麻美子,藤村歩,堀江由衣,本多陽子,牧野由依,皆川純子,三宅華也
たまゆら_(アニメ)	阿澄佳奈,井口裕香,内田彩,内山夕実,大亀あすか,緒方恵美,儀武ゆう子,合田彩,寿美菜子,竹達彩奈,恒松あゆみ,沼倉愛美,葉月絵理乃,広橋涼,福井裕佳梨,松来未祐
一騎当千	浅川悠,浅野真澄,井上喜久子,遠藤綾,甲斐田裕子,加藤英美里,門脇舞以,小林ゆう,小林由美子,三瓶由布子,真堂圭,茅原実里,生天目仁美,日笠陽子,藤村歩,松岡由貴
極上!!めちゃモテ委員長	浅川悠,榎本温子,大浦冬華,沖佳苗,おみむらまゆこ,神田朱未,三瓶由布子,下屋則子,竹内順子,田村ゆかり,千葉千恵巳,恒松あゆみ,根谷美智子,福圓美里,山本麻里安,米澤円
ロザリオとバンパイア_(アニメ)	浅倉杏美,阿澄佳奈,井上喜久子,遠藤綾,釘宮理恵,下田麻美,真堂圭,千葉紗子,氷上恭子,久川綾,福圓美里,本多知恵子,牧口真幸,水樹奈々,皆口裕子,ゆかな
宇宙をかける少女	遠藤綾,鹿野優以,栗林みな実,小清水亜美,沢城みゆき,進藤尚美,巽悠衣子,田村ゆかり,永田依子,中原麻衣,南里侑香,藤田咲,牧野由依,MAKO,松来未祐,ゆかな
ジュエルペット_サンシャイン	甲斐田ゆき,工藤晴香,齋藤彩夏,酒井香奈子,佐倉綾音,沢城みゆき,清水愛,竹内順子,久川綾,日高里菜,平野綾,MAKO,松嵜麗,皆口裕子,悠木碧,吉田仁美
大正野球娘。	浅野真澄,新井里美,今井麻美,植田佳奈,遠藤綾,甲斐田裕子,今野宏美,田村睦心,中原麻衣,能登麻美子,久川綾,広橋涼,藤村歩,牧野由依,水原薫,山本麻里安
今日の5の2	明坂聡美,浅川悠,阿澄佳奈,植田佳奈,門脇舞以,桑島法子,小林ゆう,下田麻美,高垣彩陽,茅原実里,中村知子,能登麻美子,葉月絵理乃,本多陽子,MAKO,山本麻里安
はっけん_たいけん_だいすき!_しまじろう	赤崎千夏,内田彩,岡村明美,折笠富美子,小林由美子,沢城みゆき,長谷川明子,原由実,藤田咲,藤村歩,堀江由衣,松岡由貴,皆川純子,南央美,森谷里美,吉田仁美
神のみぞ知るセカイ	阿澄佳奈,内田真礼,儀武ゆう子,小清水亜美,小林ゆう,櫻井智,佐藤聡美,竹達彩奈,丹下桜,東山奈央,沼倉愛美,花澤香菜,早見沙織,日高里菜,牧口真幸,悠木碧
はじめの一歩	浅川悠,浅野真澄,井上喜久子,岡村明美,狩野茉莉,小林ゆう,小林由美子,進藤尚美,園崎未恵,田村ゆかり,永田依子,中村知子,仁後真耶子,氷上恭子,平田宏美,松岡由貴
花咲くいろは	新井里美,遠藤綾,大浦冬華,小見川千明,金元寿子,茅野愛衣,寿美菜子,小松未可子,巽悠衣子,津田美波,恒松あゆみ,西明日香,能登麻美子,日笠陽子,本田貴子,水原薫
猫神やおよろず	新井里美,金元寿子,茅野愛衣,釘宮理恵,小林ゆう,佐藤聡美,沢城みゆき,三瓶由布子,下田麻美,高垣彩陽,竹達彩奈,中原麻衣,堀江由衣,MAKO,水橋かおり,悠木碧
最遊記シリーズ	浅井清己,井上喜久子,今井麻美,榎本温子,遠藤綾,大谷育江,甲斐田裕子,沢城みゆき,高橋理恵子,高山みなみ,田口宏子,根谷美智子,堀江由衣,松来未祐,三石琴乃,皆口裕子
ギャラクシーエンジェる〜ん	明坂聡美,井口裕香,稲村優奈,榎本温子,小野涼子,真田アサミ,沢城みゆき,新谷良子,田村ゆかり,氷上恭子,平野綾,福井裕佳梨,松岡由貴,水沢史絵,力丸乃りこ
蟲師	明坂聡美,伊瀬茉莉也,稲村優奈,岩男潤子,岡村明美,笠原弘子,小清水亜美,齋藤彩夏,坂本真綾,沢城みゆき,三瓶由布子,清水香里,鈴木真仁,千葉千恵巳,福井裕佳梨
めぇめぇもぉ	荒川美穂,内田彩,大亀あすか,小見川千明,加藤英美里,寿美菜子,佐倉綾音,佐藤聡美,清水愛,新谷良子,田村睦心,早見沙織,日高里菜,MAKO,水原薫
アガサ・クリスティーの名探偵ポワロとマープル	今井麻美,岡村明美,折笠富美子,加藤奈々絵,門脇舞以,神田理江,恒松あゆみ,中川亜紀子,根本圭子,根谷美智子,本田貴子,本名陽子,松来未祐,三石琴乃,皆川純子
怪物王女	井口裕香,井上喜久子,大浦冬華,甲斐田裕子,茅野愛衣,今野宏美,清水愛,真堂圭,竹達彩奈,能登麻美子,早見沙織,久川綾,牧口真幸,皆口裕子,森永理科
Rio_RainbowGate!	浅川悠,荒浪和沙,井上喜久子,内田彩,大亀あすか,小清水亜美,小林由美子,清水香里,竹達彩奈,茅原実里,中島沙樹,中村知子,原田ひとみ,日笠陽子,福井裕佳梨
爆転シュート_ベイブレード_(アニメ)	浅川悠,甲斐田ゆき,桑島法子,今野宏美,佐久間紅美,進藤尚美,園崎未恵,久川綾,平野綾,広橋涼,水田わさび,皆川純子,南央美,横山智佐,渡辺久美子
しましまとらのしまじろう	井上喜久子,遠藤綾,大本眞基子,桑谷夏子,後藤邑子,小林ゆう,真堂圭,高山みなみ,綱掛裕美,中川亜紀子,福圓美里,藤田咲,松岡由貴,南央美,渡辺久美子
君と僕。	内山夕実,遠藤綾,甲斐田ゆき,茅野愛衣,釘宮理恵,小林由美子,高山みなみ,竹内順子,中島沙樹,根本圭子,能登麻美子,廣田詩夢,又吉愛,松来未祐,皆川純子
ぷちぷり*ユーシィ	井上喜久子,今井麻美,折笠富美子,金田朋子,サエキトモ,坂本真綾,下屋則子,根谷美智子,福井裕佳梨,松岡由貴,望月久代,森永理科,山本麻里安,ゆかな,横山智佐
LOVELESS_(高河ゆんの漫画)	浅野真澄,新井里美,植田佳奈,小野涼子,釘宮理恵,桑島法子,小清水亜美,酒井香奈子,仲西環,能登麻美子,久川綾,堀江由衣,皆川純子,山崎和佳奈,ゆかな
WORKING!!	阿澄佳奈,岩男潤子,植田佳奈,内山夕実,折笠富美子,門脇舞以,釘宮理恵,鈴木真仁,中原麻衣,日笠陽子,広橋涼,藤田咲,水沢史絵,皆川純子,渡辺久美子
フリージング_(漫画)	浅川悠,植田佳奈,内田彩,大久保瑠美,甲斐田裕子,茅野愛衣,橘田いずみ,釘宮理恵,桑谷夏子,小清水亜美,真田アサミ,高橋理恵子,能登麻美子,花澤香菜,水沢史絵
STAR_DRIVER_輝きのタクト	小笠原亜里沙,折笠富美子,加藤英美里,桑島法子,小清水亜美,坂本真綾,竹達彩奈,千葉千恵巳,東山奈央,新名彩乃,早見沙織,日高のり子,日高里菜,広橋涼,ゆかな
フルメタル・パニック!	浅野真澄,今井麻美,金田朋子,桑谷夏子,今野宏美,沢城みゆき,田村ゆかり,根谷美智子,野田順子,能登麻美子,氷上恭子,水田わさび,水橋かおり,南央美,ゆかな
花右京メイド隊	有島モユ,今井麻美,甲斐田ゆき,門脇舞以,金田朋子,神田理江,小暮英麻,小林由美子,阪田佳代,高橋理恵子,根本圭子,早水リサ,福圓美里,又吉愛,吉住梢
スクールランブル_(アニメ)	浅川悠,井口裕香,伊瀬茉莉也,小清水亜美,小林ゆう,三瓶由布子,清水香里,生天目仁美,南里侑香,能登麻美子,平野綾,福井裕佳梨,堀江由衣,MAKO,山本麻里安
処女はお姉さまに恋してる	浅井清己,浅野真澄,神田朱未,釘宮理恵,後藤邑子,清水愛,下田麻美,真堂圭,中島沙樹,新名彩乃,福井裕佳梨,堀江由衣,松来未祐,水橋かおり,水原薫
ぷるるんっ!しずくちゃん	浅井清己,阿澄佳奈,井ノ上奈々,植田佳奈,榎本温子,大浦冬華,川田妙子,神田朱未,儀武ゆう子,釘宮理恵,下田麻美,進藤尚美,根谷美智子,松本まりか,水田わさび
ハチミツとクローバー	大浦冬華,小野涼子,釘宮理恵,工藤晴香,桑谷夏子,齋藤彩夏,佐久間紅美,恒松あゆみ,中原麻衣,生天目仁美,根谷美智子,早水リサ,本田貴子,本多陽子,皆川純子
極上生徒会	植田佳奈,甲斐田裕子,釘宮理恵,佐久間紅美,沢城みゆき,清水香里,仙台エリ,田村ゆかり,千葉紗子,生天目仁美,野田順子,久川綾,福圓美里,本多陽子,松岡由貴
恋姫†無双_(アニメ)	阿澄佳奈,壱智村小真,稲村優奈,今井麻美,小野涼子,後藤邑子,櫻井浩美,田村睦心,友永朱音,永田依子,西沢広香,平田宏美,水橋かおり,吉住梢,吉田仁美
カードキャプターさくら	井上喜久子,岩男潤子,緒方恵美,川田妙子,釘宮理恵,サエキトモ,坂本真綾,竹達彩奈,丹下桜,根谷美智子,氷上恭子,久川綾,三石琴乃,皆口裕子,ゆかな
キディ・ガーランド	井上喜久子,内田彩,桑谷夏子,合田彩,今野宏美,茅原実里,寺本來可,平野綾,牧野由依,松岡由貴,水橋かおり,水原薫,南央美,ゆかな
裏切りは僕の名前を知っている	井口裕香,植田佳奈,大浦冬華,桑島法子,佐久間紅美,田村睦心,永田依子,葉月絵理乃,日笠陽子,藤村歩,水原薫,皆川純子,ゆかな,米澤円
破天荒遊戯	阿澄佳奈,大浦冬華,甲斐田裕子,甲斐田ゆき,加藤英美里,金田朋子,櫻井智,三瓶由布子,清水愛,根谷美智子,野田順子,氷上恭子,藤田咲,松来未祐
スイートプリキュア♪	伊瀬茉莉也,大久保瑠美,折笠富美子,儀武ゆう子,小清水亜美,小林由美子,三瓶由布子,中村知子,野田順子,日高のり子,水沢史絵,三石琴乃,吉田仁美,渡辺久美子
デュラララ!!	井澤詩織,伊瀬茉莉也,沖佳苗,金元寿子,茅野愛衣,酒井香奈子,沢城みゆき,高垣彩陽,中原麻衣,花澤香菜,葉山いくみ,福圓美里,藤田咲,悠木碧
天地無用!	浅川悠,飯塚雅弓,井上喜久子,岩男潤子,金田朋子,進藤尚美,鈴木真仁,田村ゆかり,中川亜紀子,堀江由衣,水野愛日,ゆかな,横山智佐,吉住梢
GOSICK_-ゴシック-	内山夕実,甲斐田裕子,鹿野優以,桑島法子,小松未可子,沢城みゆき,下屋則子,根谷美智子,野田順子,葉月絵理乃,久川綾,堀江由衣,美名,悠木碧
鍵姫物語_永久アリス輪舞曲	浅野真澄,榎本温子,大本眞基子,金田朋子,狩野茉莉,真田アサミ,沢城みゆき,清水愛,能登麻美子,広橋涼,松来未祐,水樹奈々,水沢史絵,水野愛日
放浪息子	赤崎千夏,内田真礼,儀武ゆう子,寿美菜子,小松未可子,佐倉綾音,高部あい,田村睦心,千葉紗子,南里侑香,堀江由衣,本田貴子,水樹奈々,水原薫
れでぃ×ばと!	伊瀬茉莉也,釘宮理恵,小清水亜美,後藤邑子,佐久間紅美,巽悠衣子,中原麻衣,中村知子,花澤香菜,早見沙織,日笠陽子,日高里菜,藤村歩,米澤円
コードギアス_反逆のルルーシュ	新井里美,井上喜久子,大本眞基子,折笠富美子,小清水亜美,後藤邑子,真田アサミ,千葉紗子,福圓美里,本多陽子,松岡由貴,皆川純子,南央美,ゆかな
B型H系	浅野真澄,阿澄佳奈,門脇舞以,橘田いずみ,儀武ゆう子,小林ゆう,下田麻美,田村ゆかり,茅原実里,能登麻美子,花澤香菜,堀江由衣,水橋かおり,三森すずこ
ロックマンエグゼAXESS	釘宮理恵,下屋則子,清水愛,恒松あゆみ,中川亜紀子,根本圭子,能登麻美子,久川綾,日高のり子,本田貴子,水橋かおり,皆川純子,南央美,渡辺久美子
らき☆すた_(アニメ)	明坂聡美,井上喜久子,岩男潤子,遠藤綾,加藤英美里,鹿野優以,後藤邑子,今野宏美,島本須美,清水香里,茅原実里,平野綾,水原薫,渡辺久美子
ふたりはプリキュア_Splash_Star	伊瀬茉莉也,榎本温子,岡村明美,沖佳苗,小野涼子,甲斐田ゆき,川田妙子,齋藤彩夏,竹内順子,中川亜紀子,早水リサ,福圓美里,松来未祐,吉田仁美
ローゼンメイデン	大浦冬華,金田朋子,桑谷夏子,真田アサミ,沢城みゆき,志村由美,仁後真耶子,能登麻美子,久川綾,堀江由衣,本多陽子,水樹奈々,森永理科,力丸乃りこ
我が家のお稲荷さま。	浅川悠,浅野真澄,甲斐田裕子,鹿野優以,釘宮理恵,沢城みゆき,高垣彩陽,早見沙織,久川綾,堀江由衣,本多真梨子,水橋かおり,ゆかな,吉田仁美
魔法少女リリカルなのはA's	浅野真澄,植田佳奈,釘宮理恵,桑谷夏子,阪田佳代,佐久間紅美,真田アサミ,清水愛,清水香里,田村ゆかり,松岡由貴,松来未祐,水樹奈々,水橋かおり
うみものがたり_〜あなたがいてくれたコト〜	明坂聡美,浅川悠,阿澄佳奈,伊瀬茉莉也,大亀あすか,儀武ゆう子,桑島法子,寿美菜子,沢城みゆき,真堂圭,永井幸子,生天目仁美,福井裕佳梨,堀江由衣
くじびきアンバランス	植田佳奈,遠藤綾,大谷育江,甲斐田裕子,門脇舞以,神田朱未,小清水亜美,後藤邑子,阪田佳代,田村ゆかり,千葉紗子,水橋かおり,桃井はるこ,ゆかな
戦姫絶唱シンフォギア	赤崎千夏,井口裕香,大久保瑠美,小松未可子,佐久間紅美,沢城みゆき,高垣彩陽,高山みなみ,東山奈央,藤井ゆきよ,水樹奈々,水瀬いのり,三森すずこ,悠木碧
トリニティ・ブラッド	新井里美,大浦冬華,小野涼子,甲斐田裕子,釘宮理恵,田村ゆかり,中原麻衣,生天目仁美,根谷美智子,能登麻美子,本田貴子,松岡由貴,皆川純子,三宅華也
円盤皇女ワるきゅーレ	浅川悠,新井里美,飯塚雅弓,井上喜久子,緒方恵美,加藤奈々絵,門脇舞以,桑島法子,千葉紗子,中原麻衣,南央美,望月久代,桃井はるこ,森永理科
デ・ジ・キャラットにょ	井口裕香,榎本温子,岡村明美,齋藤彩夏,サエキトモ,真田アサミ,沢城みゆき,三瓶由布子,新谷良子,千葉千恵巳,氷上恭子,日高のり子,廣田詩夢,南央美
To_Heart	飯塚雅弓,井上喜久子,岩男潤子,大谷育江,後藤邑子,園崎未恵,田口宏子,豊嶋真千子,根谷美智子,早水リサ,氷上恭子,久川綾,堀江由衣,南央美
魔法先生ネギま!_(アニメ)	浅倉杏美,井上喜久子,門脇舞以,狩野茉莉,桑谷夏子,小林ゆう,志村由美,鈴木真仁,綱掛裕美,能登麻美子,広橋涼,堀江由衣,松岡由貴,皆川純子
DARKER_THAN_BLACK_-流星の双子-	浅井清己,加藤英美里,桑島法子,真堂圭,永田依子,生天目仁美,葉月絵理乃,花澤香菜,福圓美里,本田貴子,三上枝織,水樹奈々,森谷里美,吉住梢
らぶドル_〜Lovely_Idol〜	浅川悠,有島モユ,井上喜久子,釘宮理恵,桑谷夏子,後藤邑子,酒井香奈子,新谷良子,茅原実里,中原麻衣,仁後真耶子,福井裕佳梨,望月久代,桃井はるこ
ふしぎ星の☆ふたご姫_Gyu!	遠藤綾,大浦冬華,加藤英美里,加藤奈々絵,金田朋子,鹿野優以,後藤邑子,下屋則子,滝田樹里,永田依子,久川綾,福圓美里,水橋かおり,皆川純子
はなまる幼稚園	伊瀬茉莉也,大亀あすか,小笠原亜里沙,真堂圭,高垣彩陽,恒松あゆみ,沼倉愛美,葉月絵理乃,氷上恭子,廣田詩夢,藤村歩,本名陽子,MAKO,水原薫
もっけ	井上喜久子,遠藤綾,小笠原亜里沙,釘宮理恵,桑島法子,高垣彩陽,高山みなみ,竹内順子,野沢雅子,早水リサ,平野綾,水樹奈々,三石琴乃,ゆかな
フルーツバスケット_(漫画)	壱智村小真,遠藤綾,岡村明美,甲斐田ゆき,齋藤彩夏,佐久間紅美,清水香里,田村ゆかり,能登麻美子,久川綾,堀江由衣,松来未祐,三石琴乃,南央美
バカとテストと召喚獣	明坂聡美,磯村知美,井上喜久子,桜咲千依,加藤英美里,清水香里,竹達彩奈,永田依子,中原麻衣,原田ひとみ,水橋かおり,水原薫,三石琴乃,吉田聖子
GetBackers-奪還屋-	今井麻美,緒方恵美,甲斐田裕子,桑谷夏子,後藤邑子,小林由美子,進藤尚美,高山みなみ,根谷美智子,早水リサ,本田貴子,本多陽子,松岡由貴,りの
ファイト一発!_充電ちゃん!!	今井麻美,金田朋子,儀武ゆう子,清水愛,真堂圭,高垣彩陽,葉山いくみ,平野綾,藤東知夏,三石琴乃,美名,安野希世乃,悠木碧
ゲートキーパーズ	飯塚雅弓,井上喜久子,岩男潤子,大谷育江,桑島法子,小林由美子,今野宏美,鈴木真仁,千葉千恵巳,中島沙樹,能登麻美子,松岡由貴,水橋かおり
はたらキッズ_マイハム組	井上喜久子,大本眞基子,金田朋子,鹿野優以,川田妙子,神田朱未,佐藤聡美,進藤尚美,鈴木真仁,田中真弓,千葉千恵巳,野沢雅子,米澤円
スキップ・ビート!	榎本温子,加藤英美里,今野宏美,真堂圭,高垣彩陽,田村睦心,恒松あゆみ,永田依子,生天目仁美,早水リサ,本多陽子,三上枝織,三宅華也
いぬかみっ!	遠藤綾,甲斐田ゆき,新谷良子,長谷川明子,早水リサ,日高のり子,廣田詩夢,堀江由衣,本多陽子,又吉愛,松岡由貴,水樹奈々,森永理科
Angel_Beats!	阿澄佳奈,緒方恵美,加藤英美里,小林由美子,櫻井浩美,沢城みゆき,恒松あゆみ,中原麻衣,沼倉愛美,花澤香菜,藤田咲,牧野由依,山本彩乃
BAMBOO_BLADE	浅川悠,浅倉杏美,おみむらまゆこ,桑島法子,阪田佳代,坂本真綾,真堂圭,中原麻衣,中村知子,潘恵子,広橋涼,牧口真幸,水沢史絵
あかほり外道アワーらぶげ	飯塚雅弓,井上喜久子,榎本温子,門脇舞以,真田アサミ,清水愛,新谷良子,中原麻衣,廣田詩夢,藤田咲,又吉愛,松岡由貴,山本麻里安
少年陰陽師	大谷育江,折笠富美子,甲斐田ゆき,鹿野優以,桑谷夏子,今野宏美,竹内順子,野田順子,早水リサ,氷上恭子,又吉愛,皆川純子,三宅華也
ナイトウィザード	明坂聡美,植田佳奈,桑島法子,小暮英麻,後藤邑子,小林ゆう,坂本梓馬,永田依子,葉月絵理乃,久川綾,藤田咲,松来未祐,皆口裕子
まりあ†ほりっく	小見川千明,甲斐田裕子,加藤英美里,神田朱未,小林ゆう,佐久間紅美,真田アサミ,沢城みゆき,新谷良子,葉月絵理乃,平野綾,松来未祐,皆川純子
いちばんうしろの大魔王	井口裕香,神田朱未,寿美菜子,佐藤聡美,高垣彩陽,竹達彩奈,茅原実里,中原麻衣,日笠陽子,広橋涼,牧島有希,水原薫,悠木碧
ヴァンドレッド	浅川悠,有島モユ,井上喜久子,折笠富美子,甲斐田裕子,神田朱未,釘宮理恵,今野宏美,清水愛,根谷美智子,日高のり子,牧島有希,松本梨香
UN-GO	折笠富美子,加藤英美里,桑島法子,寿美菜子,高垣彩陽,恒松あゆみ,寺崎裕香,本田貴子,牧野由依,松本まりか,安野希世乃,山本希望,渡辺久美子
鋼殻のレギオス	浅野真澄,伊瀬茉莉也,大浦冬華,大亀あすか,甲斐田裕子,鹿野優以,釘宮理恵,小清水亜美,仙台エリ,高垣彩陽,中原麻衣,藤田咲,藤村歩
おねがい☆ツインズ	浅野真澄,井上喜久子,金田朋子,後藤邑子,佐久間紅美,沢城みゆき,清水愛,新谷良子,進藤尚美,田村ゆかり,中原麻衣,生天目仁美,根谷美智子
けんぷファー	阿澄佳奈,荒浪和沙,植田佳奈,釘宮理恵,栗林みな実,後藤邑子,田村ゆかり,永田依子,能登麻美子,堀江由衣,三上枝織,水樹奈々,皆川純子
ガンパレード・オーケストラ_(アニメ)	浅川悠,浅野真澄,榎本温子,おみむらまゆこ,神田理江,桑谷夏子,櫻井浩美,仙台エリ,千葉紗子,恒松あゆみ,中原麻衣,氷上恭子,久川綾
ブラスレイター	井口裕香,遠藤綾,栗林みな実,小林ゆう,佐久間紅美,田村睦心,中原麻衣,生天目仁美,花澤香菜,藤村歩,本多陽子,水沢史絵,皆川純子
Yes!_プリキュア5	伊瀬茉莉也,壱智村小真,沖佳苗,三瓶由布子,下屋則子,仙台エリ,竹内順子,中川亜紀子,水沢史絵,水田わさび,皆口裕子,吉田仁美,渡辺久美子
MONSTER	遠藤綾,大谷育江,岡村明美,金田朋子,桑島法子,佐久間紅美,進藤尚美,竹内順子,野田順子,能登麻美子,氷上恭子,福圓美里,水田わさび
アイドルマスター_XENOGLOSSIA	明坂聡美,井口裕香,加藤英美里,小清水亜美,櫻井智,清水香里,進藤尚美,田村ゆかり,中原麻衣,能登麻美子,堀江由衣,本多陽子,ゆかな
Myself_;_Yourself	加藤英美里,金田朋子,小清水亜美,三瓶由布子,田村ゆかり,寺崎裕香,中原麻衣,新名彩乃,氷上恭子,南央美,山本彩乃,ゆかな,吉田仁美
シゴフミ	浅野真澄,新井里美,稲村優奈,植田佳奈,折笠富美子,坂本梓馬,佐久間紅美,仙台エリ,田村睦心,千葉紗子,早見沙織,藤村歩,松岡由貴
テガミバチ	浅野真澄,植田佳奈,小清水亜美,小林ゆう,沢城みゆき,高山みなみ,生天目仁美,久川綾,藤村歩,堀江由衣,牧口真幸,松岡由貴,水樹奈々
NEEDLESS	井口裕香,伊瀬茉莉也,今井麻美,植田佳奈,遠藤綾,加藤英美里,門脇舞以,金田朋子,真堂圭,竹達彩奈,茅原実里,久川綾,牧野由依
会長はメイド様!	赤崎千夏,阿澄佳奈,伊瀬茉莉也,植田佳奈,小倉唯,甲斐田ゆき,儀武ゆう子,小林ゆう,櫻井浩美,花澤香菜,藤村歩,牧口真幸,米澤円
祝!(ハピ☆ラキ)ビックリマン	浅野真澄,池澤春菜,小林由美子,今野宏美,齋藤彩夏,園崎未恵,田中真弓,豊嶋真千子,中原麻衣,生天目仁美,西沢広香,野田順子,福圓美里
怪談レストラン	浅野真澄,大浦冬華,大谷育江,佐藤聡美,進藤尚美,鈴木真仁,高山みなみ,千葉紗子,津田美波,豊嶋真千子,福圓美里,三上枝織,渡辺久美子
十二国記	甲斐田裕子,金田朋子,釘宮理恵,桑島法子,進藤尚美,高山みなみ,千葉千恵巳,野田順子,能登麻美子,久川綾,松来未祐,山崎和佳奈,ゆかな
ヤッターマン_(2008年のテレビアニメ)	浅野真澄,今野宏美,佐藤聡美,沢城みゆき,三瓶由布子,清水愛,下田麻美,新谷良子,滝田樹里,生天目仁美,藤村歩,又吉愛,松岡由貴
ちょこッとSister	植田佳奈,狩野茉莉,釘宮理恵,小林由美子,サエキトモ,仙台エリ,野田順子,早水リサ,広橋涼,松岡由貴,水沢史絵,水橋かおり,森永理科
そらのおとしもの	大亀あすか,合田彩,寿美菜子,高垣彩陽,富樫美鈴,根谷美智子,野水伊織,早見沙織,日笠陽子,藤田咲,本多真梨子,美名,吉田仁美
エンジェル・ハート	井上喜久子,岩男潤子,大本眞基子,緒方恵美,金田朋子,桑島法子,今野宏美,高山みなみ,豊嶋真千子,野田順子,潘恵子,三石琴乃,ゆかな
ゆるゆり	内田彩,内田真礼,大久保瑠美,大坪由佳,加藤英美里,倉口桃,竹達彩奈,津田美波,藤田咲,堀江由衣,三上枝織,三森すずこ,悠木碧
家庭教師ヒットマンREBORN!	明坂聡美,稲村優奈,沖佳苗,國立幸,小林由美子,三瓶由布子,鈴木真仁,竹内順子,寺崎裕香,潘恵子,平野綾,本多知恵子,吉田仁美
マケン姫っ!	明坂聡美,伊瀬茉莉也,合田彩,下屋則子,高森奈津美,富樫美鈴,沼倉愛美,野水伊織,原田ひとみ,日高里菜,古谷静佳,松岡由貴,美名
ちゅーぶら!!	浅川悠,大浦冬華,大亀あすか,寿美菜子,巽悠衣子,茅原実里,寺本來可,永田依子,新名彩乃,日笠陽子,皆口裕子,安野希世乃
侵略!イカ娘	内山夕実,小見川千明,金元寿子,神田朱未,小西風優,小松未可子,三瓶由布子,田村睦心,生天目仁美,野田順子,藤村歩,山本彩乃
To_LOVEる_-とらぶる-	新井里美,今井麻美,大浦冬華,千葉千恵巳,寺本來可,中村知子,能登麻美子,花澤香菜,早水リサ,久川綾,福圓美里,水橋かおり
仮面のメイドガイ	浅倉杏美,井口裕香,小野涼子,甲斐田裕子,加藤英美里,神田朱未,釘宮理恵,小暮英麻,小清水亜美,小林ゆう,藤田咲,皆口裕子
魔法陣グルグル	井上喜久子,大谷育江,岡村明美,甲斐田ゆき,川田妙子,三瓶由布子,園崎未恵,根谷美智子,氷上恭子,南央美,ゆかな,横山智佐
魔人探偵脳噛ネウロ	新井里美,井上喜久子,植田佳奈,岡村明美,阪田佳代,三瓶由布子,進藤尚美,高山みなみ,千葉紗子,能登麻美子,久川綾,松本梨香
あにゃまる探偵_キルミンずぅ	沖佳苗,神田朱未,小林由美子,今野宏美,佐藤聡美,進藤尚美,田村睦心,丹下桜,根谷美智子,久川綾,広橋涼,悠木碧
俺の妹がこんなに可愛いわけがない_(アニメ)	秋谷智子,伊瀬茉莉也,小倉唯,佐倉綾音,佐藤聡美,竹達彩奈,田村ゆかり,寺本來可,生天目仁美,西明日香,花澤香菜,早見沙織
キディ・グレイド	井上喜久子,金田朋子,神田朱未,神田理江,桑谷夏子,島本須美,能登麻美子,早水リサ,久川綾,平野綾,水橋かおり,南央美
DARKER_THAN_BLACK_-黒の契約者-	浅井清己,稲村優奈,加藤英美里,三瓶由布子,進藤尚美,葉月絵理乃,福圓美里,本田貴子,松来未祐,水樹奈々,水沢史絵,皆川純子
CLAYMORE	井上喜久子,遠藤綾,鹿野優以,桑島法子,高山みなみ,竹内順子,茅原実里,久川綾,松来未祐,水樹奈々,三石琴乃,森永理科
輪るピングドラム	荒川美穂,荒浪和沙,井上喜久子,内田彩,島本須美,鈴木真仁,中原麻衣,能登麻美子,早見沙織,久川綾,堀江由衣,松嵜麗
人造昆虫カブトボーグ_V×V	明坂聡美,大橋歩夕,岡村明美,小野涼子,折笠富美子,清水香里,鈴木真仁,寺崎裕香,永井幸子,根谷美智子,葉月絵理乃,水野愛日
GUNSLINGER_GIRL	伊瀬茉莉也,榎本温子,小清水亜美,サエキトモ,酒井香奈子,坂本真綾,鈴木真仁,仙台エリ,南里侑香,能登麻美子,花澤香菜,横山智佐
週刊ストーリーランド	井上喜久子,岡村明美,金田朋子,桑島法子,島本須美,進藤尚美,田村ゆかり,久川綾,三石琴乃,皆口裕子,山崎和佳奈,渡辺久美子
苺ましまろ	井口裕香,大浦冬華,折笠富美子,寿美菜子,佐藤聡美,千葉紗子,生天目仁美,能登麻美子,福圓美里,藤村歩,本多陽子,皆川純子
Aチャンネル	内山夕実,寿美菜子,沢城みゆき,田村睦心,茅原実里,津田美波,藤田咲,牧口真幸,MAKO,又吉愛,松嵜麗,悠木碧
夏のあらし!	小見川千明,小清水亜美,小林ゆう,今野宏美,沢城みゆき,三瓶由布子,中島沙樹,中村知子,生天目仁美,根谷美智子,堀江由衣,又吉愛
みつどもえ	明坂聡美,井口裕香,井上喜久子,内田彩,甲斐田ゆき,三瓶由布子,高垣彩陽,高森奈津美,田村睦心,茅原実里,葉山いくみ,森谷里美
光と水のダフネ	浅野真澄,植田佳奈,甲斐田裕子,金田朋子,釘宮理恵,小清水亜美,下屋則子,中原麻衣,生天目仁美,野田順子,広橋涼,皆川純子
夜桜四重奏_〜ヨザクラカルテット〜	桑谷夏子,沢城みゆき,進藤尚美,高垣彩陽,田村睦心,友永朱音,中村知子,福圓美里,藤田咲,又吉愛,水原薫,三宅華也
スケッチブック_(漫画)	浅野真澄,金田朋子,桑谷夏子,小清水亜美,後藤邑子,清水香里,田村ゆかり,能登麻美子,花澤香菜,日笠陽子,広橋涼,牧野由依
ネギま!?	浅倉杏美,門脇舞以,狩野茉莉,神田朱未,桑谷夏子,小林ゆう,沢城みゆき,志村由美,能登麻美子,堀江由衣,松岡由貴,皆川純子
ぴちぴちピッチ	浅井清己,新井里美,植田佳奈,桑谷夏子,小暮英麻,後藤邑子,下屋則子,新谷良子,本田貴子,本多知恵子,松岡由貴,皆川純子
王ドロボウJING	浅井清己,飯塚雅弓,今井麻美,釘宮理恵,小林由美子,坂本真綾,田村ゆかり,千葉紗子,野沢雅子,堀江由衣,水樹奈々,三石琴乃
まよチキ!	阿澄佳奈,荒浪和沙,井口裕香,伊瀬茉莉也,小倉唯,桑谷夏子,小林ゆう,沢城みゆき,茅原実里,沼倉愛美,花澤香菜,森谷里美
超重神グラヴィオン	浅川悠,浅野真澄,池澤春菜,釘宮理恵,桑島法子,千葉紗子,中島沙樹,中原麻衣,根谷美智子,松本梨香,水樹奈々,桃井はるこ
出ましたっ!パワパフガールズZ	秋谷智子,井上喜久子,大本眞基子,加藤英美里,金田朋子,鹿野優以,儀武ゆう子,進藤尚美,仲西環,野田順子,皆口裕子,渡辺久美子
魔法少女リリカルなのはStrikerS	植田佳奈,釘宮理恵,桑谷夏子,阪田佳代,真田アサミ,清水香里,田村ゆかり,中原麻衣,又吉愛,水樹奈々,水橋かおり,ゆかな
黒神	小野涼子,甲斐田裕子,栗林みな実,下屋則子,仙台エリ,田村ゆかり,永田依子,早水リサ,久川綾,藤村歩,本田貴子,ゆかな
カレイドスター	今井麻美,折笠富美子,沢城みゆき,下屋則子,千葉千恵巳,中原麻衣,早水リサ,久川綾,平田宏美,広橋涼,水橋かおり,三石琴乃
アマガミ	浅川悠,阿澄佳奈,内山夕実,門脇舞以,今野宏美,新谷良子,花澤香菜,早水リサ,原田ひとみ,松岡由貴,水橋かおり,ゆかな
DOG_DAYS	阿澄佳奈,小清水亜美,寿美菜子,竹達彩奈,丹下桜,寺本來可,永田依子,花澤香菜,日笠陽子,堀江由衣,松来未祐,水樹奈々
げんしけん	井口裕香,遠藤綾,甲斐田ゆき,神田朱未,小清水亜美,後藤邑子,清水香里,千葉紗子,原田ひとみ,久川綾,水橋かおり,ゆかな
GIRLSブラボー	浅川悠,遠藤綾,金田朋子,桑谷夏子,齋藤彩夏,清水愛,新谷良子,能登麻美子,早水リサ,久川綾,福圓美里,松岡由貴
ゴルゴ13	榎本温子,甲斐田裕子,桑島法子,小清水亜美,高橋理恵子,高山みなみ,原田ひとみ,久川綾,藤村歩,本田貴子,牧口真幸,山本麻里安
ドルアーガの塔_(テレビアニメ)	折笠富美子,甲斐田ゆき,小林由美子,志村由美,茅原実里,根本圭子,根谷美智子,能登麻美子,花澤香菜,早水リサ,堀江由衣,ゆかな
まじしゃんず・あかでみい	伊瀬茉莉也,小清水亜美,小林ゆう,下屋則子,新谷良子,真堂圭,高垣彩陽,生天目仁美,早水リサ,福井裕佳梨,松来未祐,南央美
いつか天魔の黒ウサギ	大浦冬華,合田彩,高森奈津美,田中真奈美,田村睦心,月宮みどり,富樫美鈴,野水伊織,葉山いくみ,早見沙織,原田ひとみ,美名
PandoraHearts	大浦冬華,儀武ゆう子,坂本梓馬,櫻井浩美,田村ゆかり,花澤香菜,久川綾,広橋涼,藤村歩,堀江由衣,牧口真幸,皆川純子
バスカッシュ!	浅野真澄,遠藤綾,大浦冬華,釘宮理恵,小林ゆう,小林由美子,田村睦心,花澤香菜,早見沙織,日笠陽子,藤村歩,皆川純子
鋼の錬金術師_FULLMETAL_ALCHEMIST	井上喜久子,遠藤綾,岡村明美,折笠富美子,釘宮理恵,三瓶由布子,進藤尚美,高山みなみ,早水リサ,福圓美里,本田貴子,水樹奈々
さよなら絶望先生_(アニメ)	阿澄佳奈,井上喜久子,後藤邑子,小林ゆう,真田アサミ,沢城みゆき,新谷良子,高垣彩陽,根谷美智子,藤田咲,堀江由衣,松来未祐
かんなぎ_(漫画)	明坂聡美,浅倉杏美,小野涼子,神田朱未,沢城みゆき,島本須美,中原麻衣,中村知子,花澤香菜,早水リサ,MAKO
バトルスピリッツ_少年激覇ダン	遠藤綾,大浦冬華,金元寿子,齋藤彩夏,園崎未恵,永田依子,中村知子,根谷美智子,能登麻美子,堀江由衣,本多陽子
鉄腕バーディー_DECODE	折笠富美子,甲斐田裕子,寿美菜子,坂本真綾,田村睦心,千葉紗子,根谷美智子,能登麻美子,日笠陽子,藤村歩,皆川純子
WHITE_ALBUM	大亀あすか,沖佳苗,小野涼子,高森奈津美,田村睦心,中村知子,葉山いくみ,日笠陽子,平田宏美,平野綾,水樹奈々
神魂合体ゴーダンナー!!	甲斐田裕子,加藤奈々絵,清水香里,田村ゆかり,中原麻衣,南里侑香,能登麻美子,久川綾,本田貴子,皆川純子,山崎和佳奈
美鳥の日々	浅井清己,今井麻美,大本眞基子,釘宮理恵,桑谷夏子,佐久間紅美,清水香里,田村ゆかり,中原麻衣,長谷優里奈,平田宏美
魔法少女まどか☆マギカ	岩男潤子,大久保瑠美,加藤英美里,後藤邑子,佐倉綾音,新谷良子,中村知子,松嵜麗,水橋かおり,悠木碧,吉田聖子
べるぜバブ	池澤春菜,寿美菜子,沢城みゆき,高垣彩陽,東山奈央,生天目仁美,早見沙織,日笠陽子,藤村歩,美名,悠木碧
明日のナージャ	秋谷智子,大谷育江,岡村明美,折笠富美子,甲斐田ゆき,小清水亜美,サエキトモ,竹内順子,中川亜紀子,能登麻美子,渡辺久美子
AIR_(ゲーム)	飯塚雅弓,井上喜久子,大浦冬華,金田朋子,今野宏美,田村ゆかり,長谷優里奈,潘恵子,久川綾,堀江由衣,牧島有希
ToHeart2	小野涼子,小暮英麻,阪田佳代,櫻井浩美,中島沙樹,永田依子,生天目仁美,長谷優里奈,本多知恵子,本多陽子,力丸乃りこ
おねがいマイメロディ_〜くるくるシャッフル!〜	明坂聡美,伊瀬茉莉也,笠原弘子,小清水亜美,沢城みゆき,三瓶由布子,鈴木真仁,竹内順子,寺崎裕香,野田順子,悠木碧
S・A	浅川悠,浅野真澄,緒方恵美,桑谷夏子,小清水亜美,後藤邑子,下屋則子,清水香里,真堂圭,高垣彩陽,生天目仁美
イナズマイレブン_GO	折笠富美子,加藤奈々絵,釘宮理恵,小林ゆう,沢城みゆき,三瓶由布子,高垣彩陽,竹内順子,寺崎裕香,藤村歩,美名
シュガシュガルーン	伊瀬茉莉也,大橋歩夕,國立幸,齋藤彩夏,島本須美,清水香里,園崎未恵,竹内順子,松本まりか,皆川純子,横山智佐
バクマン。_(アニメ)	赤崎千夏,阿澄佳奈,井上喜久子,加藤英美里,櫻井浩美,恒松あゆみ,早見沙織,日高里菜,藤村歩,本多陽子,牧口真幸
おねがいマイメロディ	伊瀬茉莉也,笠原弘子,桑島法子,國立幸,小清水亜美,沢城みゆき,三瓶由布子,鈴木真仁,竹内順子,山本麻里安,悠木碧
海月姫	井澤詩織,今井麻美,岡村明美,小暮英麻,田中真奈美,能登麻美子,花澤香菜,葉山いくみ,皆口裕子,森谷里美,吉田聖子
忘却の旋律	浅野真澄,植田佳奈,大浦冬華,桑島法子,小林由美子,サエキトモ,田口宏子,田村ゆかり,中原麻衣,能登麻美子,久川綾
グラール騎士団	緒方恵美,栗林みな実,後藤邑子,清水愛,新谷良子,茅原実里,寺本來可,東山奈央,中原麻衣,能登麻美子,平野綾
Venus_Versus_Virus	加藤英美里,小林由美子,阪田佳代,下屋則子,高垣彩陽,茅原実里,生天目仁美,平田宏美,三宅華也,望月久代,山崎和佳奈
刀語	遠藤綾,大久保瑠美,儀武ゆう子,栗林みな実,田村ゆかり,中原麻衣,根本圭子,根谷美智子,早見沙織,日高里菜,広橋涼
幽☆遊☆白書	伊瀬茉莉也,大谷育江,緒方恵美,三瓶由布子,高山みなみ,田中真弓,松岡由貴,松本梨香,三石琴乃,皆川純子,横山智佐
AIKa_ZERO	桑島法子,桑谷夏子,小清水亜美,後藤邑子,小林ゆう,沢城みゆき,下田麻美,真堂圭,田村睦心,能登麻美子,福圓美里
涼宮ハルヒの憂鬱_(アニメ)	内田彩,門脇舞以,桑谷夏子,後藤邑子,茅原実里,野水伊織,平野綾,松岡由貴,三上枝織,美名,村田知沙
銀河鉄道物語	浅井清己,岩男潤子,植田佳奈,遠藤綾,加藤奈々絵,真田アサミ,沢城みゆき,野沢雅子,早水リサ,福圓美里,山崎バニラ
DearS	浅川悠,井上喜久子,鹿野優以,小林由美子,沢城みゆき,三瓶由布子,清水愛,新谷良子,田村ゆかり,中原麻衣,桃井はるこ
Fate/stay_night	浅川悠,植田佳奈,門脇舞以,桑島法子,阪田佳代,下屋則子,田村ゆかり,野田順子,能登麻美子,早見沙織,水沢史絵
フタコイ_オルタナティブ	植田佳奈,門脇舞以,桑谷夏子,小清水亜美,綱掛裕美,長谷優里奈,早水リサ,堀江由衣,本多陽子,水橋かおり,吉住梢
おまもりひまり	大亀あすか,小清水亜美,真堂圭,富樫美鈴,仁後真耶子,根谷美智子,野水伊織,本多真梨子,松岡由貴,水原薫,美名
魔法少女リリカルなのは	植田佳奈,釘宮理恵,桑谷夏子,清水愛,清水香里,田村ゆかり,久川綾,松岡由貴,松来未祐,水樹奈々,水橋かおり
お兄ちゃんのことなんかぜんぜん好きじゃないんだからねっ!!	明坂聡美,荒浪和沙,井上喜久子,大久保瑠美,金元寿子,茅原実里,野水伊織,葉山いくみ,MAKO,森谷里美,吉田聖子
テイルズ_オブ_ジ_アビス	井上喜久子,岩男潤子,大谷育江,菊地ゆうみ,釘宮理恵,小林由美子,田村睦心,根谷美智子,本田貴子,桃井はるこ,ゆかな
機神大戦ギガンティック・フォーミュラ	井上喜久子,大浦冬華,甲斐田ゆき,釘宮理恵,栗林みな実,桑島法子,國立幸,小清水亜美,沢城みゆき,高山みなみ,福圓美里
男子高校生の日常	小清水亜美,小林ゆう,三瓶由布子,高垣彩陽,早水リサ,日笠陽子,三石琴乃,皆川純子,悠木碧,ゆかな,米澤円
ブラック★ロックシューター	阿澄佳奈,今井麻美,内山夕実,坂本真綾,沢城みゆき,下田麻美,中村知子,沼倉愛美,能登麻美子,花澤香菜,日笠陽子
ティアーズ・トゥ・ティアラ_花冠の大地	浅井清己,阿澄佳奈,植田佳奈,小野涼子,小清水亜美,後藤邑子,沢城みゆき,清水愛,下田麻美,中原麻衣,三宅華也
悪霊シリーズ	井口裕香,稲村優奈,井ノ上奈々,狩野茉莉,釘宮理恵,沢城みゆき,新谷良子,鈴木真仁,園崎未恵,寺崎裕香,南央美
BLUE_DRAGON_(アニメ)	浅野真澄,新井里美,遠藤綾,甲斐田裕子,小林ゆう,中島沙樹,生天目仁美,根本圭子,葉月絵理乃,藤田咲,藤村歩
スケアクロウマン	飯塚雅弓,榎本温子,加藤英美里,高山みなみ,千葉紗子,生天目仁美,南里侑香,潘恵子,平野綾,牧口真幸,山本麻里安
学校の怪談_(テレビアニメ)	浅井清己,大谷育江,緒方恵美,折笠富美子,川田妙子,小暮英麻,坂本真綾,佐久間紅美,本田貴子,三石琴乃,ゆかな
アストロボーイ・鉄腕アトム	飯塚雅弓,大谷育江,甲斐田裕子,釘宮理恵,進藤尚美,高山みなみ,根谷美智子,野沢雅子,松本梨香,南央美,ゆかな
X_(漫画)	井上喜久子,岩男潤子,桑島法子,佐久間紅美,根谷美智子,能登麻美子,久川綾,松本梨香,三石琴乃,皆口裕子,ゆかな
銀装騎攻オーディアン	浅川悠,池澤春菜,今井麻美,榎本温子,桑島法子,サエキトモ,田村ゆかり,根谷美智子,氷上恭子,堀江由衣,三石琴乃
アソボット戦記五九	浅川悠,飯塚雅弓,榎本温子,神田理江,三瓶由布子,下屋則子,高山みなみ,千葉千恵巳,皆川純子,ゆかな,横山智佐
ベン・トー	荒川美穂,伊瀬茉莉也,加藤英美里,茅野愛衣,佐倉綾音,竹達彩奈,田村ゆかり,寺川愛美,堀江由衣,水原薫,悠木碧
素敵探偵☆ラビリンス	井上喜久子,井ノ上奈々,植田佳奈,榎本温子,鹿野優以,佐藤聡美,沢城みゆき,能登麻美子,藤田咲,藤村歩,堀江由衣
ひぐらしのなく頃に_(アニメ)	井上喜久子,大浦冬華,折笠富美子,小林ゆう,田村ゆかり,友永朱音,中原麻衣,花澤香菜,堀江由衣,水沢史絵,水野愛日
ジュエルペット_(アニメ)	伊瀬茉莉也,甲斐田ゆき,橘田いずみ,齋藤彩夏,酒井香奈子,沢城みゆき,竹内順子,平野綾,皆川純子,悠木碧,吉田仁美
TIGER_&_BUNNY	伊瀬茉莉也,遠藤綾,甲斐田裕子,寿美菜子,坂本真綾,田村睦心,中原麻衣,中村知子,根谷美智子,日高里菜,皆川純子
高橋留美子劇場	池澤春菜,井上喜久子,大谷育江,小林ゆう,島本須美,高山みなみ,豊嶋真千子,潘恵子,皆口裕子,南央美,渡辺久美子
ながされて藍蘭島	浅野真澄,飯塚雅弓,釘宮理恵,田村ゆかり,千葉紗子,千葉千恵巳,生天目仁美,堀江由衣,松岡由貴,三石琴乃,三宅華也
輪廻のラグランジェ	赤崎千夏,浅倉杏美,金元寿子,茅野愛衣,南里侑香,能登麻美子,野水伊織,藤村歩,三森すずこ,森谷里美
D・N・ANGEL	浅野真澄,井上喜久子,小野涼子,門脇舞以,金田朋子,川田妙子,釘宮理恵,小林由美子,田村ゆかり,丹下桜
夢喰いメリー	秋谷智子,浅野真澄,井口裕香,伊瀬茉莉也,植田佳奈,遠藤綾,茅野愛衣,佐倉綾音,高森奈津美,日高里菜
君に届け	伊瀬茉莉也,大本眞基子,沖佳苗,工藤晴香,沢城みゆき,三瓶由布子,長嶋はるか,能登麻美子,平野綾,牧口真幸
機動戦士ガンダム00	遠藤綾,小笠原亜里沙,釘宮理恵,真堂圭,高垣彩陽,高山みなみ,恒松あゆみ,根谷美智子,早水リサ,本名陽子
機動戦士ガンダムSEED_DESTINY	浅川悠,井上喜久子,折笠富美子,桑島法子,小林ゆう,坂本真綾,進藤尚美,根谷美智子,早水リサ,三石琴乃
学園アリス	植田佳奈,遠藤綾,大浦冬華,神田理江,釘宮理恵,沢城みゆき,早水リサ,福圓美里,水橋かおり,皆川純子
Dr.リンにきいてみて!	大浦冬華,甲斐田ゆき,笠原弘子,鈴木真仁,園崎未恵,竹内順子,千葉紗子,天神有海,本多知恵子,横山智佐
ぱにょぱにょデ・ジ・キャラット	今井麻美,榎本温子,真田アサミ,沢城みゆき,三瓶由布子,竹内順子,能登麻美子,氷上恭子,南央美,山本麻里安
らんま1/2	井上喜久子,岩男潤子,岡村明美,儀武ゆう子,真堂圭,高山みなみ,日高のり子,福井裕佳梨,松本梨香,山田栄子
世紀末オカルト学院	荒浪和沙,内田彩,小林ゆう,高垣彩陽,茅原実里,花澤香菜,葉山いくみ,日笠陽子,久川綾,水瀬いのり
Tactics_(漫画)	植田佳奈,甲斐田裕子,門脇舞以,儀武ゆう子,仲西環,生天目仁美,能登麻美子,松来未祐,水樹奈々,南央美
うたわれるもの	儀武ゆう子,釘宮理恵,沢城みゆき,田口宏子,竹達彩奈,恒松あゆみ,中原麻衣,水橋かおり,三宅華也,米澤円
キューティーハニー	岩男潤子,甲斐田ゆき,金田朋子,今野宏美,島本須美,進藤尚美,鈴木真仁,根谷美智子,原由実,堀江由衣
学園黙示録_HIGHSCHOOL_OF_THE_DEAD	沢城みゆき,清水香里,竹内順子,竹達彩奈,中村知子,生天目仁美,原田ひとみ,福井裕佳梨,藤村歩,本名陽子
ドラゴノーツ_-ザ・レゾナンス-	小野涼子,後藤邑子,小林ゆう,沢城みゆき,仙台エリ,千葉紗子,茅原実里,平野綾,福井裕佳梨,水樹奈々
まぶらほ	浅野真澄,岡村明美,桑島法子,下屋則子,千葉千恵巳,中原麻衣,生天目仁美,野田順子,松岡由貴,水樹奈々
ナジカ電撃作戦	井上喜久子,折笠富美子,釘宮理恵,桑谷夏子,真田アサミ,新谷良子,根谷美智子,氷上恭子,水橋かおり,ゆかな
真剣で私に恋しなさい!	浅川悠,井澤詩織,緒方恵美,後藤邑子,阪田佳代,櫻井浩美,友永朱音,西沢広香,水橋かおり,力丸乃りこ
ビックリマン2000	岩男潤子,笠原弘子,小林由美子,鈴木真仁,仙台エリ,園崎未恵,竹内順子,根谷美智子,本多知恵子,横山智佐
バトルスピリッツ_少年突破バシン	大本眞基子,神田朱未,進藤尚美,高垣彩陽,田村睦心,根谷美智子,福圓美里,水原薫,三宅華也,ゆかな
テレパシー少女「蘭」事件ノート	明坂聡美,浅倉杏美,阿澄佳奈,植田佳奈,榎本温子,岡村明美,折笠富美子,加藤英美里,小清水亜美,清水愛
金色のコルダ	新井里美,遠藤綾,小野涼子,鹿野優以,神田朱未,桑島法子,真田アサミ,志村由美,恒松あゆみ,水橋かおり
ケメコデラックス!	今井麻美,遠藤綾,釘宮理恵,佐藤聡美,千葉紗子,能登麻美子,花澤香菜,平野綾,水沢史絵,三石琴乃
かみちゅ!	甲斐田裕子,甲斐田ゆき,神田朱未,小林由美子,平田宏美,広橋涼,福圓美里,MAKO,望月久代,森永理科
ときめきメモリアル_Only_Love	浅野真澄,井口裕香,井上喜久子,門脇舞以,釘宮理恵,清水愛,田村ゆかり,藤田咲,牧島有希,松来未祐
機動新撰組_萌えよ剣	池澤春菜,金田朋子,今野宏美,沢城みゆき,進藤尚美,田中真弓,田村ゆかり,三石琴乃,山崎和佳奈,横山智佐
ラブひな	浅川悠,桑谷夏子,小林由美子,鈴木真仁,野沢雅子,野田順子,久川綾,福圓美里,堀江由衣,水樹奈々
生徒会の一存	寿美菜子,清水愛,新谷良子,真堂圭,高垣彩陽,富樫美鈴,能登麻美子,日笠陽子,堀中優希,本多真梨子
激闘!クラッシュギアTURBO	浅川悠,大本眞基子,神田朱未,真田アサミ,進藤尚美,中川亜紀子,根谷美智子,本田貴子,水田わさび,南央美
Strawberry_Panic_(アニメ)	大浦冬華,甲斐田裕子,桑谷夏子,清水愛,中島沙樹,中原麻衣,生天目仁美,野田順子,福井裕佳梨,松来未祐
つよきす_Cool×Sweet	有島モユ,井ノ上奈々,おみむらまゆこ,金田朋子,儀武ゆう子,小林ゆう,佐久間紅美,中原麻衣,藤田咲,水樹奈々
彩雲国物語_(アニメ)	浅倉杏美,岡村明美,甲斐田ゆき,桑島法子,仙台エリ,園崎未恵,綱掛裕美,根本圭子,氷上恭子,三宅華也
とらドラ!	阿澄佳奈,大浦冬華,小野涼子,甲斐田裕子,釘宮理恵,下田麻美,田村睦心,中村知子,日笠陽子,堀江由衣
スクラップド・プリンセス	折笠富美子,桑島法子,桑谷夏子,佐久間紅美,根谷美智子,早水リサ,本田貴子,松岡由貴,水橋かおり,南央美
ズッコケ三人組	植田佳奈,岡村明美,甲斐田ゆき,神田朱未,今野宏美,進藤尚美,高山みなみ,堀江由衣,水田わさび,横山智佐
機動戦士ガンダムSEED	井上喜久子,桑島法子,小林ゆう,坂本真綾,進藤尚美,高垣彩陽,豊嶋真千子,沼倉愛美,日笠陽子,三石琴乃
花田少年史	緒方恵美,川田妙子,桑島法子,高山みなみ,竹内順子,田中真弓,根谷美智子,久川綾,松本梨香,皆口裕子
タクティカルロア	新井里美,植田佳奈,大浦冬華,小野涼子,門脇舞以,小林由美子,中原麻衣,能登麻美子,皆川純子,三宅華也
月面兎兵器ミーナ_(テレビアニメ)	井口裕香,伊瀬茉莉也,小野涼子,中島沙樹,根谷美智子,能登麻美子,長谷川明子,花澤香菜,皆口裕子,南央美
せんせいのお時間	今井麻美,植田佳奈,大谷育江,金田朋子,下屋則子,清水香里,生天目仁美,南央美,山崎和佳奈,渡辺久美子
セイクリッドセブン	赤崎千夏,茅野愛衣,佐倉綾音,高部あい,田中真奈美,田村睦心,南里侑香,野水伊織,三上枝織,水原薫
まほろまてぃっく	井上喜久子,今井麻美,金田朋子,真田アサミ,清水愛,新谷良子,滝田樹里,能登麻美子,水野愛日,桃井はるこ
宙のまにまに	伊瀬茉莉也,金元寿子,小清水亜美,寿美菜子,沢城みゆき,高垣彩陽,花澤香菜,葉山いくみ,早見沙織,悠木碧
マジカノ	井ノ上奈々,金田朋子,桑谷夏子,後藤邑子,酒井香奈子,真堂圭,中原麻衣,桃井はるこ,ゆかな,力丸乃りこ
ヤミと帽子と本の旅人	井上喜久子,笠原弘子,神田理江,清水愛,野田順子,能登麻美子,氷上恭子,松来未祐,山本麻里安,ゆかな
エマ_(漫画)	井上喜久子,遠藤綾,甲斐田裕子,釘宮理恵,下屋則子,島本須美,恒松あゆみ,早水リサ,本名陽子,水橋かおり
SoltyRei	浅野真澄,稲村優奈,桑谷夏子,沢城みゆき,島本須美,真堂圭,田村ゆかり,豊嶋真千子,能登麻美子,広橋涼
シムーン_(アニメ)	桑島法子,小清水亜美,高橋理恵子,能登麻美子,福圓美里,松来未祐,水樹奈々,水沢史絵,森永理科,ゆかな
バトルスピリッツ_ブレイヴ	遠藤綾,大浦冬華,折笠富美子,金元寿子,桑島法子,進藤尚美,高垣彩陽,根谷美智子,本多陽子,ゆかな
キミキス	池澤春菜,大浦冬華,儀武ゆう子,小清水亜美,佐久間紅美,中原麻衣,能登麻美子,原田ひとみ,広橋涼,水橋かおり
生徒会役員共	新井里美,小見川千明,加藤英美里,小林ゆう,佐藤聡美,下田麻美,田村睦心,寺本來可,日笠陽子,松来未祐
ハイスクールD×D	浅倉杏美,大亀あすか,小倉唯,佐久間紅美,高森奈津美,竹達彩奈,巽悠衣子,生天目仁美,日笠陽子,水原薫
そふてにっ	明坂聡美,大谷育江,寿美菜子,沢城みゆき,高垣彩陽,巽悠衣子,早見沙織,氷上恭子,三上枝織,山本彩乃
おでんくん	荒浪和沙,内田彩,大浦冬華,大本眞基子,金田朋子,今野宏美,佐藤聡美,千葉千恵巳,恒松あゆみ,野田順子
鉄のラインバレル	植田佳奈,神田朱未,釘宮理恵,沢城みゆき,下屋則子,能登麻美子,平田宏美,平野綾,本名陽子,ゆかな
ヒャッコ	折笠富美子,甲斐田裕子,笠原弘子,桑島法子,佐藤聡美,根谷美智子,長谷優里奈,平野綾,堀江由衣,山本彩乃
天保異聞_妖奇士	井上喜久子,折笠富美子,進藤尚美,高山みなみ,千葉紗子,野沢雅子,早水リサ,久川綾,藤村歩,山崎バニラ
コレクター・ユイ	大本眞基子,甲斐田ゆき,進藤尚美,園崎未恵,天神有海,豊嶋真千子,根谷美智子,本多知恵子,三石琴乃,渡辺久美子
双恋	門脇舞以,桑谷夏子,小清水亜美,小林由美子,綱掛裕美,長谷優里奈,堀江由衣,水橋かおり,吉住梢
聖闘士星矢_冥王神話	阿澄佳奈,小笠原亜里沙,菊地ゆうみ,坂本真綾,下屋則子,根本圭子,平野綾,本田貴子,水樹奈々
モノクローム・ファクター	浅野真澄,神田朱未,小清水亜美,田村ゆかり,千葉千恵巳,永田依子,早見沙織,日笠陽子,米澤円
神霊狩/GHOST_HOUND	井口裕香,遠藤綾,清水香里,永田依子,根谷美智子,能登麻美子,早見沙織,日笠陽子,藤村歩
隠の王	小野涼子,鹿野優以,釘宮理恵,佐久間紅美,真堂圭,田村ゆかり,生天目仁美,藤村歩,三石琴乃
かしまし_〜ガール・ミーツ・ガール〜	浅野真澄,植田佳奈,大浦冬華,儀武ゆう子,新谷良子,田村ゆかり,堀江由衣,本多陽子,松来未祐
プリズム・アーク_〜プリズム・ハート_エピソード2〜	浅川悠,浅野真澄,阿澄佳奈,門脇舞以,小林ゆう,仲西環,生天目仁美,水橋かおり,桃井はるこ
GTO_(漫画)	浅井清己,緒方恵美,岡村明美,折笠富美子,島本須美,野田順子,氷上恭子,本田貴子,三石琴乃
砂漠の海賊!キャプテンクッパ	川田妙子,神田理江,桑島法子,サエキトモ,下屋則子,高山みなみ,千葉紗子,根谷美智子,三石琴乃
まっすぐにいこう。	井上喜久子,折笠富美子,金田朋子,下屋則子,鈴木真仁,恒松あゆみ,能登麻美子,日高のり子,渡辺久美子
かのこん	門脇舞以,下屋則子,進藤尚美,竹内美優,仲西環,中村知子,能登麻美子,早水リサ,松来未祐
人形草紙あやつり左近	井上喜久子,小笠原亜里沙,緒方恵美,甲斐田ゆき,桑島法子,坂本真綾,丹下桜,久川綾,山崎和佳奈
魔探偵ロキ	浅井清己,神田理江,坂本真綾,下屋則子,中原麻衣,能登麻美子,福圓美里,堀江由衣,南央美
ご愁傷さま二ノ宮くん	明坂聡美,門脇舞以,後藤邑子,沢城みゆき,進藤尚美,高垣彩陽,千葉紗子,綱掛裕美,根谷美智子
ロミオ×ジュリエット	岩男潤子,園崎未恵,中島沙樹,葉月絵理乃,久川綾,広橋涼,松来未祐,水沢史絵,森永理科
ワイルド三人娘	緒方恵美,栗林みな実,後藤邑子,清水愛,新谷良子,茅原実里,中原麻衣,能登麻美子,平野綾
スティッチ!	折笠富美子,小林由美子,田村ゆかり,豊嶋真千子,中原麻衣,根谷美智子,日笠陽子,松岡由貴,松本梨香
西洋骨董洋菓子店	折笠富美子,佐藤聡美,真田アサミ,沢城みゆき,園崎未恵,永田依子,本田貴子,牧口真幸,山崎和佳奈
デッドマン・ワンダーランド	大浦冬華,茅野愛衣,合田彩,沢城みゆき,高森奈津美,野水伊織,花澤香菜,本田貴子,美名
瀬戸の花嫁_(漫画)	金田朋子,桑谷夏子,恒松あゆみ,広橋涼,三石琴乃,桃井はるこ,森永理科,山崎バニラ,力丸乃りこ
こんにちは_アン_〜Before_Green_Gables	大谷育江,川田妙子,小林由美子,進藤尚美,根谷美智子,久川綾,日高里菜,水沢史絵,山田栄子
夢使い	浅野真澄,門脇舞以,鹿野優以,三瓶由布子,真堂圭,能登麻美子,久川綾,廣田詩夢,南央美
ANGELIC_LAYER	井上喜久子,植田佳奈,榎本温子,金田朋子,桑島法子,能登麻美子,堀江由衣,水橋かおり,三石琴乃
神様ドォルズ	緒方恵美,茅野愛衣,桑谷夏子,小林由美子,沢城みゆき,仙台エリ,高垣彩陽,花澤香菜,福圓美里
GA_芸術科アートデザインクラス	伊瀬茉莉也,神田朱未,小清水亜美,佐藤聡美,沢城みゆき,高山みなみ,葉山いくみ,堀江由衣,南央美
プリティーリズム・オーロラドリーム	明坂聡美,阿澄佳奈,上坂すみれ,桑島法子,中原麻衣,早水リサ,日高のり子,藤村歩,米澤円
トップをねらえ2!	浅野真澄,甲斐田裕子,小林ゆう,坂本真綾,沢城みゆき,生天目仁美,福井裕佳梨,本名陽子,松岡由貴
キノの旅	井上喜久子,甲斐田ゆき,佐久間紅美,園崎未恵,野田順子,能登麻美子,久川綾,悠木碧,りの
ちっちゃな雪使いシュガー	浅野真澄,川田妙子,小林由美子,サエキトモ,真田アサミ,中川亜紀子,水橋かおり,三石琴乃,皆口裕子
焼きたて!!ジャぱん	神田朱未,釘宮理恵,小林由美子,田中真弓,豊嶋真千子,根谷美智子,能登麻美子,氷上恭子,水樹奈々
うえきの法則	浅川悠,小林由美子,櫻井浩美,清水愛,茅原実里,野沢雅子,能登麻美子,氷上恭子,堀江由衣
スーパーロボット大戦OG_-ジ・インスペクター-	浅川悠,岩男潤子,緒方恵美,甲斐田ゆき,小林由美子,清水香里,根谷美智子,平井理子,松本梨香
吸血姫美夕_(テレビアニメ)	岩男潤子,緒方恵美,岡村明美,笠原弘子,島本須美,田村ゆかり,氷上恭子,三石琴乃,ゆかな
Over_Drive_(漫画)	井口裕香,儀武ゆう子,小林由美子,茅原実里,久川綾,藤村歩,本多陽子,牧口真幸,米澤円
奥さまは魔法少女	浅野真澄,井上喜久子,門脇舞以,釘宮理恵,小林ゆう,清水愛,本多陽子,松本梨香,渡辺久美子
ふしぎ星の☆ふたご姫	後藤邑子,清水愛,早水リサ,潘恵子,福圓美里,水橋かおり,皆川純子,皆口裕子,山崎バニラ
NANA	岡村明美,鈴木真仁,田村ゆかり,千葉紗子,早水リサ,平野綾,藤村歩,本田貴子,皆川純子
絶対衝激_〜PLATONIC_HEART〜	明坂聡美,今井麻美,植田佳奈,甲斐田裕子,門脇舞以,神田朱未,小清水亜美,新谷良子,平田宏美
朝霧の巫女	今井麻美,甲斐田裕子,加藤奈々絵,神田理江,下屋則子,清水愛,広橋涼,堀江由衣,南央美
ぽぽたん	浅野真澄,甲斐田ゆき,門脇舞以,下屋則子,中原麻衣,早水リサ,広橋涼,望月久代,桃井はるこ
青い文学シリーズ	遠藤綾,甲斐田ゆき,鹿野優以,川田妙子,桑島法子,竹内順子,能登麻美子,久川綾,水樹奈々
イナズマイレブン_(アニメ)	折笠富美子,甲斐田ゆき,加藤奈々絵,釘宮理恵,小林由美子,三瓶由布子,高垣彩陽,竹内順子,森谷里美
デルトラ・クエスト	加藤英美里,釘宮理恵,下屋則子,高垣彩陽,恒松あゆみ,中島沙樹,根本圭子,本田貴子,三宅華也
鋼の錬金術師_(アニメ)	折笠富美子,甲斐田裕子,釘宮理恵,桑島法子,根谷美智子,氷上恭子,松来未祐,水樹奈々,三石琴乃
愛天使伝説ウェディングピーチ	池澤春菜,岩男潤子,川田妙子,中川亜紀子,根谷美智子,氷上恭子,本多知恵子,三石琴乃,ゆかな
シャーマンキング	井上喜久子,甲斐田裕子,進藤尚美,高山みなみ,根谷美智子,堀江由衣,水樹奈々,山崎和佳奈,渡辺久美子
クロノクルセイド	栗林みな実,桑谷夏子,小暮英麻,高山みなみ,千葉紗子,根谷美智子,本多真梨子,皆川純子,力丸乃りこ
ぴたテン	今井麻美,岡村明美,川田妙子,釘宮理恵,沢城みゆき,田村ゆかり,能登麻美子,早水リサ,ゆかな
カイバ	甲斐田裕子,桑島法子,小林由美子,佐久間紅美,三瓶由布子,進藤尚美,能登麻美子,藤村歩,水田わさび
おとめ妖怪_ざくろ	井口裕香,井上喜久子,小野涼子,寿美菜子,田村睦心,中原麻衣,花澤香菜,堀江由衣,本田貴子
かなめも	井口裕香,井澤詩織,遠藤綾,釘宮理恵,下田麻美,広橋涼,堀江由衣,松嵜麗,水原薫
かりん_(漫画)	儀武ゆう子,下屋則子,恒松あゆみ,生天目仁美,久川綾,廣田詩夢,広橋涼,松来未祐,三宅華也
カードファイト!!_ヴァンガード	榎本温子,大久保瑠美,橘田いずみ,寺川愛美,徳井青空,生天目仁美,広橋涼,牧口真幸,三森すずこ
メイプルストーリー	遠藤綾,折笠富美子,桑島法子,今野宏美,久川綾,日高のり子,松本梨香,水樹奈々,皆口裕子
爆裂天使	今井麻美,植田佳奈,小林ゆう,園崎未恵,恒松あゆみ,野田順子,早水リサ,氷上恭子,吉住梢
烈火の炎	浅井清己,今井麻美,緒方恵美,桑島法子,中川亜紀子,野田順子,本多知恵子,三石琴乃,皆口裕子
アベノ橋魔法☆商店街	岡村明美,金田朋子,サエキトモ,進藤尚美,野田順子,氷上恭子,久川綾,堀江由衣,松岡由貴
灼眼のシャナ	浅野真澄,井口裕香,加藤奈々絵,釘宮理恵,小林由美子,櫻井智,田村ゆかり,堀江由衣,皆口裕子
七人のナナ	金田朋子,佐久間紅美,島本須美,中原麻衣,葉月絵理乃,福井裕佳梨,松来未祐,水樹奈々,水野愛日
それでも町は廻っている	小見川千明,加藤英美里,仙台エリ,滝田樹里,田村睦心,藤村歩,松来未祐,悠木碧,吉田聖子
SAMURAI_DEEPER_KYO	浅野真澄,今井麻美,植田佳奈,緒方恵美,小林由美子,堀江由衣,水樹奈々,三石琴乃,ゆかな
BLOOD+	甲斐田裕子,門脇舞以,小清水亜美,坂本梓馬,進藤尚美,中村知子,野田順子,本多陽子,森永理科
雪の女王_(NHKアニメ)	浅井清己,有島モユ,大谷育江,島本須美,野沢雅子,潘恵子,日高のり子,三石琴乃,横山智佐
伯爵と妖精	浅野真澄,新井里美,橘田いずみ,釘宮理恵,沢城みゆき,仙台エリ,千葉千恵巳,水樹奈々,山本彩乃
デジモンセイバーズ	壱智村小真,沖佳苗,小野涼子,甲斐田裕子,甲斐田ゆき,金田朋子,釘宮理恵,野沢雅子,ゆかな
MOONLIGHT_MILE	浅川悠,井上喜久子,門脇舞以,根谷美智子,早水リサ,牧島有希,水原薫,望月久代
ガン×ソード	井上喜久子,大本眞基子,桑島法子,小林ゆう,千葉紗子,野田順子,南央美,渡辺久美子
CLAMP学園探偵団	池澤春菜,井上喜久子,緒方恵美,岡村明美,坂本真綾,日高のり子,南央美,ゆかな
IS_〈インフィニット・ストラトス〉	門脇舞以,下屋則子,下田麻美,田村ゆかり,花澤香菜,原由実,日笠陽子,ゆかな
貧乏姉妹物語	金田朋子,鹿野優以,釘宮理恵,酒井香奈子,坂本真綾,進藤尚美,茅原実里,久川綾
史上最強の弟子ケンイチ	大本眞基子,桑島法子,高山みなみ,根谷美智子,能登麻美子,久川綾,水野愛日,皆川純子
あの日見た花の名前を僕達はまだ知らない。	赤崎千夏,大浦冬華,茅野愛衣,佐倉綾音,田村睦心,早見沙織,牧野由依,水原薫
鋼鉄天使くるみ	今井麻美,榎本温子,岡村明美,桑島法子,園崎未恵,根谷美智子,三石琴乃,南央美
流星戦隊ムスメット	浅井清己,浅野真澄,井ノ上奈々,榎本温子,新名彩乃,松来未祐,桃井はるこ,山本麻里安
すもももももも_地上最強のヨメ	井上喜久子,加藤英美里,鹿野優以,中島沙樹,中村知子,平野綾,松来未祐,米澤円
テニスの王子様_(アニメ)	大浦冬華,甲斐田ゆき,小林由美子,千葉紗子,永井幸子,南里侑香,松本梨香,皆川純子
魔術士オーフェン_(アニメ)	飯塚雅弓,小林由美子,田村ゆかり,野田順子,堀江由衣,水橋かおり,三石琴乃,南央美
かみちゃまかりん	甲斐田ゆき,加藤奈々絵,寿美菜子,佐藤聡美,沢城みゆき,下屋則子,中原麻衣,吉住梢
ささめきこと	大久保瑠美,加藤英美里,高垣彩陽,竹達彩奈,早見沙織,早水リサ,原田ひとみ,牧口真幸
Sola	小野涼子,金田朋子,小清水亜美,三瓶由布子,清水愛,中原麻衣,能登麻美子,本多陽子
パンティ&ストッキングwithガーターベルト	伊瀬茉莉也,榎本温子,遠藤綾,小笠原亜里沙,生天目仁美,日笠陽子,藤村歩,水原薫
ペンギン娘	秋谷智子,明坂聡美,伊瀬茉莉也,門脇舞以,鈴木真仁,高垣彩陽,日高里菜,本多知恵子
アニメーション神戸	遠藤綾,大山のぶ代,加藤英美里,後藤邑子,小林ゆう,坂本真綾,茅原実里,平野綾
クロスゲーム	浅野真澄,神田朱未,下屋則子,根本圭子,野沢雅子,氷上恭子,松岡由貴,皆川純子
C3_-シーキューブ-	阿澄佳奈,井口裕香,小倉唯,田村ゆかり,茅原実里,MAKO,水原薫,三石琴乃
WOLF'S_RAIN	稲村優奈,小笠原亜里沙,川田妙子,小暮英麻,坂本真綾,沢城みゆき,仙台エリ,松来未祐
異世界の聖機師物語	釘宮理恵,桑谷夏子,今野宏美,園崎未恵,恒松あゆみ,野田順子,松来未祐,米澤円
百花繚乱_SAMURAI_GIRLS	釘宮理恵,小清水亜美,寿美菜子,小林ゆう,中村知子,水原薫,森谷里美,悠木碧
ケンコー全裸系水泳部_ウミショー	井口裕香,岡村明美,小林ゆう,清水愛,新谷良子,高垣彩陽,生天目仁美,福井裕佳梨
戦国乙女〜桃色パラドックス〜	明坂聡美,伊瀬茉莉也,沖佳苗,國立幸,東山奈央,日高里菜,松来未祐,持月玲依
CANAAN	坂本真綾,沢城みゆき,高垣彩陽,田村睦心,中村知子,能登麻美子,皆川純子,吉田聖子
戦う司書シリーズ	釘宮理恵,沢城みゆき,田村ゆかり,能登麻美子,平田宏美,広橋涼,牧口真幸,吉田聖子
ペルソナ_〜トリニティ・ソウル〜	阿澄佳奈,荒浪和沙,沢城みゆき,中原麻衣,能登麻美子,日笠陽子,松嵜麗,水沢史絵
あかね色に染まる坂	加藤英美里,釘宮理恵,小林ゆう,真田アサミ,西沢広香,葉月絵理乃,平野綾,広橋涼
バカ姉弟	植田佳奈,大本眞基子,岡村明美,金田朋子,川田妙子,小林由美子,松岡由貴,水橋かおり
天元突破グレンラガン	阿澄佳奈,植田佳奈,門脇舞以,下屋則子,根谷美智子,福井裕佳梨,本田貴子,松嵜麗
デジモンフロンティア	新井里美,大本眞基子,甲斐田ゆき,川田妙子,竹内順子,天神有海,能登麻美子,渡辺久美子
しにがみのバラッド。	植田佳奈,大浦冬華,甲斐田ゆき,金田朋子,小清水亜美,清水愛,能登麻美子,広橋涼
半分の月がのぼる空	儀武ゆう子,今野宏美,下田麻美,田村ゆかり,平野綾,松岡由貴,松来未祐,水橋かおり
フィギュア17_つばさ&ヒカル	井上喜久子,今井麻美,折笠富美子,神田理江,釘宮理恵,小林由美子,堀江由衣,本田貴子
ありす_in_Cyberland	井上喜久子,緒方恵美,丹下桜,根谷美智子,氷上恭子,久川綾,三石琴乃,渡辺久美子
よんでますよ、アザゼルさん。	甲斐田裕子,釘宮理恵,小林ゆう,東山奈央,沼倉愛美,葉月絵理乃,福圓美里,皆川純子
R.O.D_-THE_TV-	門脇舞以,川田妙子,小暮英麻,鈴木真仁,田村ゆかり,根谷美智子,早水リサ,平田宏美
成恵の世界	壱智村小真,桑谷夏子,後藤邑子,新谷良子,田村ゆかり,千葉紗子,能登麻美子,皆川純子
グイン・サーガ	明坂聡美,甲斐田裕子,寿美菜子,佐藤聡美,中原麻衣,根谷美智子,皆川純子,山崎和佳奈
こどものじかん	門脇舞以,下田麻美,真堂圭,高垣彩陽,長谷川明子,藤村歩,本多陽子,水原薫
エア・ギア	伊瀬茉莉也,沖佳苗,小林ゆう,下屋則子,高垣彩陽,早見沙織,福井裕佳梨,山崎和佳奈
封神演義_(漫画)	池澤春菜,緒方恵美,甲斐田ゆき,高山みなみ,千葉千恵巳,天神有海,堀江由衣,松本梨香
Kiss×sis	今井麻美,大亀あすか,小倉唯,佐藤聡美,竹達彩奈,巽悠衣子,寺本來可,永田依子
フレッシュプリキュア!	飯塚雅弓,沖佳苗,中川亜紀子,根谷美智子,氷上恭子,藤井ゆきよ,吉田仁美,渡辺久美子
二十面相の娘	新井里美,沢城みゆき,田村睦心,中村知子,平野綾,水沢史絵,皆川純子,吉田聖子
明日のよいち!	井口裕香,佐藤聡美,田村睦心,田村ゆかり,生天目仁美,花澤香菜,藤村歩,牧野由依
妄想代理人	進藤尚美,仲西環,生天目仁美,能登麻美子,早水リサ,水樹奈々,三石琴乃,桃井はるこ
山戸めぐみ	大谷育江,岡村明美,沢城みゆき,氷上恭子,松嵜麗,森谷里美,山本彩乃,吉田聖子
あまえないでよっ!!	門脇舞以,小林ゆう,真田アサミ,新谷良子,中原麻衣,根谷美智子,水樹奈々,三石琴乃
REC_(漫画)	浅野真澄,大浦冬華,小野涼子,酒井香奈子,長谷優里奈,福圓美里,水橋かおり,三宅華也
シスター・プリンセス_RePure	門脇舞以,桑谷夏子,小林由美子,真田アサミ,千葉千恵巳,堀江由衣,水樹奈々,望月久代
DEATH_NOTE_(アニメ)	有島モユ,小野涼子,工藤晴香,小清水亜美,坂本真綾,日高のり子,平野綾,牧口真幸
Kanon_(ゲーム)	飯塚雅弓,小野涼子,坂本真綾,田村ゆかり,堀江由衣,本多陽子,皆口裕子,三宅華也
こどものおもちゃ	緒方恵美,岡村明美,齋藤彩夏,竹内順子,中川亜紀子,福井裕佳梨,南央美,横山智佐
ブギーポップシリーズ	浅川悠,折笠富美子,齋藤彩夏,清水香里,田村ゆかり,千葉紗子,能登麻美子,吉住梢
スマイルプリキュア!	赤崎千夏,大谷育江,小野涼子,金元寿子,田野アサミ,津田美波,福圓美里,吉田仁美
GAD_GUARD	井上喜久子,折笠富美子,小林由美子,千葉千恵巳,中川亜紀子,仲西環,早水リサ,ゆかな
11eyes_-罪と罰と贖いの少女-	浅川悠,壱智村小真,加藤英美里,田村睦心,中原麻衣,新名彩乃,水橋かおり,力丸乃りこ
超魔神英雄伝ワタル	浅川悠,大本眞基子,岡村明美,鈴木真仁,田中真弓,野田順子,三石琴乃,横山智佐
Gift_〜ギフト〜	井口裕香,榎本温子,大浦冬華,門脇舞以,小清水亜美,清水愛,新谷良子,米澤円
ライブオン_CARDLIVER_翔	井上喜久子,折笠富美子,菊地ゆうみ,櫻井智,清水愛,鈴木真仁,中島沙樹,望月久代
MASTERキートン	井上喜久子,岡村明美,桑島法子,島本須美,根谷美智子,久川綾,松本梨香,皆口裕子
RAY_(漫画)	浅野真澄,新井里美,桑島法子,千葉紗子,生天目仁美,広橋涼,堀江由衣,本名陽子
うた∽かた	浅野真澄,植田佳奈,桑島法子,田村ゆかり,生天目仁美,長谷優里奈,本田貴子,本多陽子
RAGNAROK_THE_ANIMATION	磯村知美,稲村優奈,植田佳奈,小林ゆう,中島沙樹,久川綾,水樹奈々,桃井はるこ
東京アンダーグラウンド	浅井清己,飯塚雅弓,大谷育江,下屋則子,中川亜紀子,野田順子,松来未祐,三石琴乃
ワールド・デストラクション	小林ゆう,坂本真綾,沢城みゆき,進藤尚美,中川亜紀子,久川綾,福圓美里,藤村歩
ボボボーボ・ボーボボ	榎本温子,大本眞基子,金田朋子,鹿野優以,今野宏美,進藤尚美,中原麻衣,山崎和佳奈
新白雪姫伝説プリーティア	井上喜久子,今井麻美,神田朱未,今野宏美,田村ゆかり,仲西環,福圓美里,堀江由衣
レジェンズ	岩男潤子,岡村明美,齋藤彩夏,沢城みゆき,清水香里,鈴木真仁,三石琴乃,南央美
おねがいマイメロディ_すっきり♪	伊瀬茉莉也,井ノ上奈々,桑島法子,小清水亜美,沢城みゆき,鈴木真仁,竹内順子,悠木碧
キルミーベイベー	赤崎千夏,新井里美,橘田いずみ,釘宮理恵,高部あい,田村睦心,徳井青空,三森すずこ
荒川アンダー_ザ_ブリッジ	小見川千明,後藤邑子,小林ゆう,坂本真綾,沢城みゆき,三瓶由布子,新谷良子,根谷美智子
風の聖痕	植田佳奈,酒井香奈子,新谷良子,真堂圭,長谷優里奈,藤村歩,牧野由依,森永理科
エル・カザド	金田朋子,桑島法子,清水愛,恒松あゆみ,南里侑香,久川綾,三石琴乃,山本麻里安
ニニンがシノブ伝	折笠富美子,釘宮理恵,小林由美子,生天目仁美,根谷美智子,本多陽子,水樹奈々,三石琴乃
ヒカルの碁	浅川悠,今井麻美,榎本温子,金元寿子,田村ゆかり,本田貴子,水田わさび,渡辺久美子
センチメンタルジャーニー_(アニメ)	今野宏美,田村ゆかり,豊嶋真千子,中川亜紀子,根谷美智子,野田順子,牧島有希,三石琴乃
A&G_REQUEST_デジスタ	大亀あすか,栗林みな実,高垣彩陽,竹達彩奈,野水伊織,日笠陽子,藤田咲,吉田仁美
D.C.II_〜ダ・カーポII〜	浅川悠,下田麻美,高垣彩陽,田村ゆかり,茅原実里,長谷川明子,堀江由衣,水橋かおり
おおきく振りかぶって	志村由美,恒松あゆみ,中村知子,生天目仁美,早水リサ,福圓美里,藤田咲,水沢史絵
爆走兄弟レッツ&ゴー!!	浅川悠,池澤春菜,大谷育江,大本眞基子,日高のり子,堀江由衣,南央美,渡辺久美子
戦争童話	金田朋子,桑島法子,小林由美子,島本須美,野沢雅子,日高のり子,松岡由貴,松本梨香
IGPX	浅井清己,小野涼子,小清水亜美,進藤尚美,仲西環,堀江由衣,三石琴乃,山崎バニラ
ゼーガペイン	遠藤綾,小野涼子,門脇舞以,花澤香菜,久川綾,牧野由依,南央美,ゆかな
緋弾のアリア	浅野真澄,伊瀬茉莉也,金元寿子,釘宮理恵,巽悠衣子,中原麻衣,西明日香,水原薫
電波女と青春男	明坂聡美,井口裕香,大亀あすか,加藤英美里,田中真奈美,永田依子,花澤香菜
フラクタル_(テレビアニメ)	井口裕香,小林ゆう,今野宏美,島本須美,津田美波,花澤香菜,松嵜麗
聖ルミナス女学院	浅川悠,飯塚雅弓,大本眞基子,齋藤彩夏,野田順子,堀江由衣,水野愛日
ご近所物語	豊嶋真千子,根谷美智子,野田順子,福井裕佳梨,皆口裕子,山崎和佳奈,渡辺久美子
ウィッチブレイド_(アニメ)	小野涼子,神田朱未,園崎未恵,能登麻美子,福圓美里,水樹奈々,水沢史絵
ムシウタ	加藤英美里,志村由美,仙台エリ,田村ゆかり,生天目仁美,能登麻美子,花澤香菜
ひだまりスケッチ	阿澄佳奈,小見川千明,後藤邑子,新谷良子,滝田樹里,松来未祐,水橋かおり
エクスドライバー	加藤奈々絵,小林由美子,沢城みゆき,根谷美智子,松本梨香,水橋かおり,三石琴乃
ドラゴンボールZ	伊瀬茉莉也,緒方恵美,田中真弓,豊嶋真千子,野沢雅子,久川綾,皆口裕子
シスター・プリンセス	桑谷夏子,小林由美子,千葉千恵巳,氷上恭子,堀江由衣,水樹奈々,望月久代
蒼穹のファフナー	新井里美,仲西環,早水リサ,福圓美里,松来未祐,松本まりか,ゆかな
交響詩篇エウレカセブン	加藤英美里,小清水亜美,三瓶由布子,根谷美智子,久川綾,福圓美里,水沢史絵
モンキーターン_(漫画)	岡村明美,神田朱未,豊嶋真千子,根谷美智子,野田順子,久川綾,南央美
VIRUS	飯塚雅弓,池澤春菜,緒方恵美,笠原弘子,桑島法子,根谷美智子,皆口裕子
まもって守護月天!	浅野真澄,岩男潤子,金田朋子,桑島法子,堀江由衣,南央美,山崎和佳奈
∀ガンダム	大谷育江,折笠富美子,後藤邑子,高橋理恵子,本田貴子,遊魚静,渡辺久美子
満月をさがして	大浦冬華,緒方恵美,笠原弘子,島本須美,竹内順子,天神有海,本多知恵子
あまつき	小林ゆう,進藤尚美,原田ひとみ,廣田詩夢,本田貴子,松岡由貴,水野愛日
BLACK_CAT	井上喜久子,高山みなみ,千葉千恵巳,早水リサ,福圓美里,皆川純子,ゆかな
ヒートガイジェイ	飯塚雅弓,甲斐田裕子,坂本真綾,清水愛,千葉紗子,根谷美智子,能登麻美子
E'S	浅野真澄,池澤春菜,岩男潤子,日高のり子,福圓美里,南央美,望月久代
ラーゼフォン	浅川悠,浅野真澄,折笠富美子,桑島法子,坂本真綾,田口宏子,久川綾
こばと。	折笠富美子,桑島法子,真堂圭,高垣彩陽,中島沙樹,花澤香菜,福圓美里
武装錬金	釘宮理恵,小林ゆう,下屋則子,生天目仁美,平野綾,水田わさび,皆川純子
東京国際アニメフェア	井口裕香,大山のぶ代,小見川千明,栗林みな実,齋藤彩夏,葉月絵理乃,平野綾
クッキンアイドル_アイ!マイ!まいん!	笠原弘子,金元寿子,酒井香奈子,島本須美,出野泉花,福原遥,横山智佐
サイボーグ009_(アニメ)	井上喜久子,島本須美,園崎未恵,高山みなみ,野沢雅子,潘恵子,本田貴子
MOUSE	井上喜久子,サエキトモ,真田アサミ,新谷良子,中原麻衣,福井裕佳梨,桃井はるこ
Saint_October	井口裕香,沖佳苗,笠原弘子,小林ゆう,鈴木真仁,茅原実里,福井裕佳梨
W〜ウィッシュ〜	稲村優奈,金田朋子,清水愛,新谷良子,千葉紗子,南里侑香,松来未祐
聖剣の刀鍛冶	浅野真澄,井上喜久子,沢城みゆき,新谷良子,茅原実里,藤村歩,米澤円
祝福のカンパネラ	壱智村小真,今井麻美,門脇舞以,後藤邑子,長谷川明子,平田宏美,水橋かおり
無敵看板娘	大浦冬華,甲斐田裕子,小清水亜美,中島沙樹,生天目仁美,藤村歩,水沢史絵
まほらば	浅野真澄,新井里美,清水愛,天神有海,中原麻衣,堀江由衣,三石琴乃
ココロ図書館	今井麻美,金田朋子,桑谷夏子,坂本真綾,沢城みゆき,進藤尚美,根谷美智子
レンタルマギカ	植田佳奈,大浦冬華,岡村明美,甲斐田裕子,釘宮理恵,小林由美子,高垣彩陽
屍姫	飯塚雅弓,遠藤綾,大浦冬華,小林由美子,千葉紗子,堀江由衣,悠木碧
ギルティクラウン	遠藤綾,茅野愛衣,寿美菜子,竹達彩奈,津田美波,花澤香菜,藤東知夏
吉永さん家のガーゴイル	稲村優奈,儀武ゆう子,桑島法子,園崎未恵,藤田咲,松来未祐,水樹奈々
藏合紗恵子	合田彩,月宮みどり,富樫美鈴,野水伊織,古谷静佳,本多真梨子,美名
KURAU_Phantom_Memory	小野涼子,甲斐田裕子,笠原弘子,釘宮理恵,島本須美,園崎未恵,吉住梢
タユタマ_-Kiss_on_my_Deity-	大亀あすか,下田麻美,富樫美鈴,葉山いくみ,本多陽子,水橋かおり,力丸乃りこ
ガラスの艦隊	植田佳奈,大浦冬華,甲斐田裕子,釘宮理恵,沢城みゆき,園崎未恵,福圓美里
ソ・ラ・ノ・ヲ・ト	植田佳奈,遠藤綾,小野涼子,金元寿子,小林ゆう,福圓美里,悠木碧
アリソンシリーズ	桑島法子,小林ゆう,高垣彩陽,能登麻美子,福圓美里,藤村歩,水樹奈々
プリンセスチュチュ	今井麻美,加藤奈々絵,神田朱未,沢城みゆき,能登麻美子,葉月絵理乃,水樹奈々
ノエイン_もうひとりの君へ	岡村明美,加藤英美里,工藤晴香,千葉紗子,中原麻衣,本田貴子,本多陽子
遊☆戯☆王デュエルモンスターズ	大浦冬華,島本須美,鈴木真仁,仙台エリ,竹内順子,松本梨香,横山智佐
びんちょうタン	井上喜久子,門脇舞以,釘宮理恵,中原麻衣,生天目仁美,福圓美里,松来未祐
みなみけ	小野涼子,寿美菜子,齋藤彩夏,千葉紗子,茅原実里,水樹奈々,森永理科
ハイスクールミステリー学園七不思議	川田妙子,久川綾,本多知恵子,三石琴乃,山崎和佳奈,横山智佐,渡辺久美子
デビルメイクライ_(アニメ)	岡村明美,折笠富美子,儀武ゆう子,桑谷夏子,久川綾,福圓美里,ゆかな
機動戦士ガンダムAGE	遠藤綾,大亀あすか,小清水亜美,高垣彩陽,恒松あゆみ,中村知子,早見沙織
Get_Ride!_アムドライバー	笠原弘子,サエキトモ,園崎未恵,竹内順子,能登麻美子,本多知恵子,山本麻里安
女子高生_(漫画)	浅野真澄,清水愛,生天目仁美,能登麻美子,氷上恭子,福圓美里,又吉愛
人間交差点	大谷育江,岡村明美,甲斐田裕子,小林由美子,サエキトモ,進藤尚美,広橋涼
住めば都のコスモス荘	浅野真澄,井上喜久子,釘宮理恵,桑谷夏子,小林由美子,清水香里,三石琴乃
The_Soul_Taker_〜魂狩〜	浅野真澄,榎本温子,大谷育江,高山みなみ,田村ゆかり,根谷美智子,桃井はるこ
いちご100%	植田佳奈,清水愛,能登麻美子,早水リサ,日高のり子,広橋涼,水樹奈々
ななか6/17	大谷育江,真田アサミ,三瓶由布子,千葉紗子,千葉千恵巳,久川綾,堀江由衣
灰羽連盟	浅野真澄,折笠富美子,野田順子,久川綾,広橋涼,松来未祐,水野愛日
攻殻機動隊_STAND_ALONE_COMPLEX	浅井清己,小笠原亜里沙,坂本真綾,仙台エリ,高山みなみ,根谷美智子,氷上恭子
アルジェントソーマ	有島モユ,井上喜久子,榎本温子,神田朱未,桑島法子,堀江由衣,牧島有希
黒執事_(アニメ)	加藤英美里,後藤邑子,坂本真綾,田村ゆかり,平野綾,藤村歩,水樹奈々
天使になるもんっ!	飯塚雅弓,大谷育江,川田妙子,丹下桜,日高のり子,南央美,ゆかな
ゴクドーくん漫遊記	浅川悠,大本眞基子,緒方恵美,川田妙子,桑島法子,野田順子,水野愛日
メダロット_(アニメ)	甲斐田ゆき,小林由美子,坂本真綾,鈴木真仁,仙台エリ,竹内順子,本多知恵子
ジバクくん	浅川悠,岩男潤子,緒方恵美,鈴木真仁,高山みなみ,田村ゆかり,野田順子
ナースウィッチ小麦ちゃんマジカルて	榎本温子,大谷育江,清水愛,田村ゆかり,根谷美智子,桃井はるこ,山本麻里安
ヒロイック・エイジ	新井里美,釘宮理恵,小清水亜美,沢城みゆき,清水香里,田村ゆかり,ゆかな
キスダム_-ENGAGE_planet-	明坂聡美,井口裕香,遠藤綾,甲斐田裕子,門脇舞以,高山みなみ,水樹奈々
ママレード・ボーイ	井上喜久子,丹下桜,豊嶋真千子,野田順子,潘恵子,久川綾,山崎和佳奈
アクエリオンEVOL	茅野愛衣,田村睦心,丹下桜,花澤香菜,藤村歩,森谷里美,安野希世乃
初恋限定。	井口裕香,伊瀬茉莉也,寿美菜子,佐藤聡美,早見沙織,藤村歩,本多陽子
異国迷路のクロワーゼ	儀武ゆう子,進藤尚美,照井春佳,東山奈央,能登麻美子,原嶋あかり,悠木碧
京四郎と永遠の空	緒方恵美,阪田佳代,下屋則子,永田依子,葉月絵理乃,松岡由貴,望月久代
ヤマトナデシコ七変化_(漫画)	大本眞基子,笠原弘子,今野宏美,中原麻衣,根谷美智子,皆川純子,森永理科
あずまんが大王	浅川悠,金田朋子,桑島法子,齋藤彩夏,清水愛,久川綾,松岡由貴
姫様ご用心	甲斐田裕子,真田アサミ,沢城みゆき,新谷良子,千葉千恵巳,早水リサ,吉住梢
FF：U_〜ファイナルファンタジー:アンリミテッド〜	井上喜久子,植田佳奈,桑島法子,氷上恭子,皆口裕子,桃井はるこ,ゆかな
MADLAX	金田朋子,神田理江,桑島法子,千葉紗子,南里侑香,久川綾,三石琴乃
藍より青し	島本須美,千葉千恵巳,能登麻美子,広橋涼,堀江由衣,水橋かおり,桃井はるこ
えむえむっ!	阿澄佳奈,儀武ゆう子,桑島法子,竹達彩奈,早見沙織,久川綾,堀江由衣
ARMS	大本眞基子,緒方恵美,桑島法子,高山みなみ,千葉紗子,久川綾,本多知恵子
神様家族	金田朋子,鹿野優以,神田朱未,小清水亜美,能登麻美子,広橋涼,山崎和佳奈
ストラトス・フォー	浅川悠,折笠富美子,清水香里,園崎未恵,根谷美智子,松本梨香,水橋かおり
.hack//黄昏の腕輪伝説	浅野真澄,甲斐田ゆき,坂本真綾,仲西環,中原麻衣,松岡由貴,皆川純子
Another	合田彩,高森奈津美,富樫美鈴,原田ひとみ,福圓美里,吉田聖子,米澤円
ZOMBIE-LOAN	浅野真澄,井口裕香,植田佳奈,門脇舞以,桑島法子,櫻井智,真田アサミ
ドラゴンクライシス!	加藤英美里,橘田いずみ,釘宮理恵,仁後真耶子,堀江由衣,松岡由貴,ゆかな
スパイダーライダーズ_〜オラクルの勇者たち〜	浅川悠,浅野真澄,榎本温子,清水香里,千葉紗子,本田貴子,牧野由依
おおかみかくし	伊瀬茉莉也,加藤英美里,後藤邑子,小林ゆう,南里侑香,葉山いくみ,藤田咲
ましろ色シンフォニー	赤崎千夏,壱智村小真,小野涼子,櫻井浩美,田口宏子,友永朱音,力丸乃りこ
ぽてまよ	井上喜久子,小野涼子,甲斐田裕子,釘宮理恵,花澤香菜,久川綾,藤村歩
ヴァリアブル・ジオ	岩男潤子,大谷育江,根谷美智子,三石琴乃,ゆかな,横山智佐,渡辺久美子
赤ずきんチャチャ	櫻井智,島本須美,鈴木真仁,田中真弓,日高のり子,本多知恵子,松本梨香
バトルスピリッツ_覇王	鹿野優以,園崎未恵,中村知子,能登麻美子,藤井ゆきよ,藤田咲,水沢史絵
恋する天使アンジェリーク	鹿野優以,三瓶由布子,恒松あゆみ,藤村歩,本名陽子,水原薫,三石琴乃
純情ロマンチカ	壱智村小真,門脇舞以,櫻井浩美,真堂圭,西沢広香,原田ひとみ,水樹奈々
鬼神童子ZENKI	大谷育江,緒方恵美,島本須美,高山みなみ,根谷美智子,三石琴乃,横山智佐
青の祓魔師_(アニメ)	内山夕実,甲斐田裕子,小林由美子,高垣彩陽,東山奈央,花澤香菜,藤村歩
新機動戦記ガンダムW	沖佳苗,栗林みな実,高山みなみ,根谷美智子,横山智佐,渡辺久美子
ひまわりっ!	明坂聡美,壱智村小真,鹿野優以,日高のり子,平田宏美,平野綾
宇宙交響詩メーテル_銀河鉄道999外伝	井上喜久子,清水愛,茅原実里,生天目仁美,潘恵子,皆川純子
機動戦士ガンダム_第08MS小隊	井上喜久子,大谷育江,高橋理恵子,田村ゆかり,本多知恵子,横山智佐
衛星アニメ劇場	浅川悠,岩男潤子,植田佳奈,甲斐田ゆき,新名彩乃,水田わさび
あの夏で待ってる	阿澄佳奈,大浦冬華,進藤尚美,田村ゆかり,久川綾,日高里菜
AYAKASHI	小林ゆう,清水愛,真堂圭,高垣彩陽,松来未祐,水樹奈々
チャンス〜トライアングルセッション〜	飯塚雅弓,今井麻美,植田佳奈,榎本温子,釘宮理恵,山本麻里安
神無月の巫女	浅井清己,植田佳奈,大谷育江,下屋則子,能登麻美子,南央美
ほんとにあった!霊媒先生	加藤英美里,竹達彩奈,葉山いくみ,松来未祐,水原薫,山本彩乃
となグラ!	加藤英美里,神田朱未,恒松あゆみ,葉月絵理乃,本多陽子,森永理科
眼鏡なカノジョ	今井麻美,生天目仁美,花澤香菜,早見沙織,森谷里美,山本彩乃
神風怪盗ジャンヌ	桑島法子,後藤邑子,天神有海,根谷美智子,三石琴乃,山崎和佳奈
BLOOD-C	浅野真澄,内山夕実,佐々木智代,福圓美里,水樹奈々,吉田聖子
あゆまゆ劇場	浅井清己,栗林みな実,田口宏子,長谷川明子,水橋かおり,吉住梢
源氏物語千年紀_Genji	遠藤綾,沖佳苗,小清水亜美,小林由美子,佐藤聡美,牧口真幸
錬金3級_まじかる?ぽか〜ん	明坂聡美,門脇舞以,金田朋子,仲西環,生天目仁美,平野綾
電脳コイル	折笠富美子,桑島法子,小林由美子,進藤尚美,野田順子,本田貴子
銀色のオリンシス	折笠富美子,神田朱未,千葉紗子,久川綾,牧島有希,三石琴乃
妖狐×僕SS	井澤詩織,津田美波,花澤香菜,日笠陽子,日高里菜,三上枝織
牙_(アニメ)	井上喜久子,遠藤綾,葉月絵理乃,平田宏美,水樹奈々,森永理科
まめゴマ	小林ゆう,仙台エリ,南里侑香,藤村歩,松来未祐,水沢史絵
鬼公子炎魔	千葉紗子,能登麻美子,久川綾,松岡由貴,山本麻里安,吉住梢
冒険王ビィト	鹿野優以,釘宮理恵,仲西環,久川綾,広橋涼,松岡由貴
青の6号	浅川悠,齋藤彩夏,千葉千恵巳,根谷美智子,水橋かおり,ゆかな
バッカーノ!	神田朱未,釘宮理恵,小林ゆう,高垣彩陽,広橋涼,松嵜麗
エルフェンリート	神田朱未,下屋則子,生天目仁美,能登麻美子,松岡由貴,山本麻里安
電波的な彼女	植田佳奈,小清水亜美,小林ゆう,中原麻衣,広橋涼,吉住梢
テイルズ_オブ_エターニア_THE_ANIMATION	神田朱未,中原麻衣,堀江由衣,三石琴乃,皆口裕子,南央美
ヴァンパイア騎士	植田佳奈,折笠富美子,笠原弘子,中原麻衣,堀江由衣,皆川純子
エルフを狩るモノたち	浅川悠,高山みなみ,野田順子,三石琴乃,南央美,山田栄子
学園戦記ムリョウ	浅野真澄,釘宮理恵,小林由美子,日高のり子,平田宏美,山崎和佳奈
おねがい☆ティーチャー	井上喜久子,金田朋子,新谷良子,進藤尚美,田村ゆかり,南央美
おとぎストーリー_天使のしっぽ	千葉紗子,仁後真耶子,根谷美智子,氷上恭子,平野綾,ゆかな
蒼穹のファフナー_HEAVEN_AND_EARTH	新井里美,遠藤綾,仲西環,福圓美里,松本まりか,ゆかな
GEAR戦士電童	有島モユ,小林由美子,進藤尚美,根谷美智子,牧島有希,三石琴乃
こいこい7	稲村優奈,儀武ゆう子,佐久間紅美,中島沙樹,松来未祐,水樹奈々
よくわかる現代魔法	寿美菜子,佐藤聡美,田村睦心,生天目仁美,日笠陽子,藤村歩
アスラクライン	阿澄佳奈,小見川千明,甲斐田裕子,佐藤聡美,日笠陽子,平田宏美
タイタニア	植田佳奈,甲斐田裕子,寿美菜子,潘恵子,牧島有希,皆川純子
探偵オペラ_ミルキィホームズ_第2幕	赤崎千夏,橘田いずみ,沢城みゆき,徳井青空,松岡由貴,三森すずこ
護くんに女神の祝福を!	大浦冬華,真田アサミ,清水愛,千葉紗子,生天目仁美,能登麻美子
東京マグニチュード8.0	井上喜久子,遠藤綾,甲斐田裕子,小林由美子,沢城みゆき,中原麻衣
トラブルチョコレート	大谷育江,丹下桜,綱掛裕美,氷上恭子,堀江由衣,本田貴子
出撃!マシンロボレスキュー	後藤邑子,進藤尚美,早水リサ,松本梨香,山本麻里安,ゆかな
万能野菜_ニンニンマン	井上喜久子,茅野愛衣,釘宮理恵,佐藤聡美,田村睦心,早見沙織
CODE-E	浅川悠,稲村優奈,小林ゆう,真堂圭,高垣彩陽,桃井はるこ
僕は友達が少ない	井口裕香,佐倉綾音,中村知子,花澤香菜,福圓美里,山本希望
HAND_MAID_メイ	井上喜久子,釘宮理恵,小暮英麻,氷上恭子,南央美,山本麻里安
シャイニング・ティアーズ・クロス・ウィンド	桑島法子,佐久間紅美,広橋涼,福圓美里,堀江由衣,水樹奈々
ジャングルはいつもハレのちグゥ	大本眞基子,田口宏子,田村ゆかり,野田順子,氷上恭子,松岡由貴
デジモンアドベンチャー02	壱智村小真,竹内順子,天神有海,野田順子,能登麻美子,山崎和佳奈
ミラクル☆トレイン	阿澄佳奈,内田彩,小清水亜美,酒井香奈子,仙台エリ,本多陽子
Dr.スランプ	大本眞基子,川田妙子,桑島法子,野沢雅子,野田順子,皆口裕子
アニカン	井上喜久子,今井麻美,神田朱未,下田麻美,葉月絵理乃,桃井はるこ
にゃんこい!	井口裕香,今井麻美,小林ゆう,恒松あゆみ,福井裕佳梨,山本彩乃
ちょびっツ	井上喜久子,折笠富美子,桑島法子,進藤尚美,広橋涼,ゆかな
こはるびより	明坂聡美,井口裕香,小清水亜美,清水愛,早見沙織,三宅華也
Φなる・あぷろーち	稲村優奈,儀武ゆう子,田村ゆかり,中島沙樹,松来未祐,皆口裕子
HAUNTEDじゃんくしょん	飯塚雅弓,池澤春菜,岩男潤子,大谷育江,氷上恭子,三石琴乃
阿貴的家族	新井里美,川田妙子,釘宮理恵,小林ゆう,園崎未恵,野沢雅子
MUNTOシリーズ	井上喜久子,内田彩,釘宮理恵,寿美菜子,今野宏美,水原薫
彼氏彼女の事情	榎本温子,桑谷夏子,千葉紗子,野田順子,福井裕佳梨,山本麻里安
カウボーイビバップ	小笠原亜里沙,桑島法子,坂本真綾,堀江由衣,水田わさび,吉住梢
ウルトラマニアック	浅井清己,おみむらまゆこ,神田朱未,小暮英麻,千葉紗子,堀江由衣
07-GHOST	浅倉杏美,伊瀬茉莉也,小倉唯,生天目仁美,能登麻美子,早見沙織
インタールード_(ゲーム)	大谷育江,大本眞基子,桑島法子,田村ゆかり,豊嶋真千子,山崎和佳奈
天地無用!_GXP	金田朋子,佐久間紅美,進藤尚美,能登麻美子,久川綾,水樹奈々
SAMURAI_7	浅川悠,遠藤綾,折笠富美子,小林ゆう,高橋理恵子,渡辺久美子
格闘美神_武龍	浅川悠,小野涼子,早水リサ,水田わさび,皆川純子,山崎和佳奈
甲虫王者ムシキング	浅野真澄,神田朱未,小林ゆう,進藤尚美,竹内順子,皆口裕子
LAST_EXILE	桑谷夏子,根谷美智子,野田順子,花澤香菜,山崎和佳奈,ゆかな
神秘の世界エルハザード	井上喜久子,今野宏美,坂本真綾,櫻井智,中川亜紀子,根谷美智子
遊☆戯☆王_(アニメ第1作)	緒方恵美,根谷美智子,野田順子,山崎和佳奈,山田栄子,ゆかな
遊☆戯☆王デュエルモンスターズGX	笠原弘子,櫻井智,鈴木真仁,仙台エリ,永井幸子,根谷美智子
北へ。〜Diamond_Dust_Drops〜	佐久間紅美,園崎未恵,中島沙樹,能登麻美子,広橋涼,皆川純子
こみっくパーティー	今井麻美,阪田佳代,佐久間紅美,園崎未恵,能登麻美子,堀江由衣
無限のリヴァイアス	飯塚雅弓,桑島法子,丹下桜,氷上恭子,堀江由衣,南央美
無限の住人	阿澄佳奈,坂本真綾,千葉紗子,根本圭子,能登麻美子,三宅華也
シグマ・セブン	阪田佳代,福圓美里,水樹奈々,水沢史絵,ゆかな,遊魚静
怪_〜ayakashi〜	鹿野優以,神田朱未,桑島法子,千葉紗子,広橋涼,ゆかな
PIANO	浅野真澄,小林由美子,清水香里,根谷美智子,氷上恭子,りの
僕等がいた	明坂聡美,稲村優奈,榎本温子,三瓶由布子,清水香里,寺崎裕香
BOYS_BE…	おみむらまゆこ,折笠富美子,根谷美智子,野田順子,福圓美里,水野愛日
この醜くも美しい世界	今井麻美,門脇舞以,小林ゆう,真田アサミ,清水愛,水野愛日
魔法少女猫たると	浅井清己,岡村明美,久川綾,水橋かおり,望月久代,山本麻里安
Phantom_〜Requiem_for_the_Phantom〜	小清水亜美,櫻井智,沢城みゆき,高垣彩陽,久川綾,水橋かおり
Bビーダマン爆外伝V	浅川悠,川田妙子,桑島法子,小林由美子,松本梨香,山崎和佳奈
スカイガールズ	大浦冬華,小野涼子,沢城みゆき,生天目仁美,堀江由衣,水沢史絵
落花流水_(漫画)	遠藤綾,金田朋子,沢城みゆき,中原麻衣,生天目仁美,松岡由貴
奇鋼仙女ロウラン	浅井清己,浅野真澄,大谷育江,大本眞基子,緒方恵美,今野宏美
ブレイド_(2011年のアニメ)	坂本真綾,高垣彩陽,根谷美智子,皆川純子,森谷里美,吉田聖子
宇宙のステルヴィア	折笠富美子,甲斐田裕子,進藤尚美,根谷美智子,広橋涼,松岡由貴
劇場版_銀魂_新訳紅桜篇	折笠富美子,釘宮理恵,小林ゆう,島本須美,根本圭子,早水リサ
新撰組異聞PEACE_MAKER	井ノ上奈々,加藤奈々絵,小林由美子,佐久間紅美,沢城みゆき,根谷美智子
BURN-UP	岡村明美,釘宮理恵,丹下桜,能登麻美子,氷上恭子,水樹奈々
妖逆門	加藤奈々絵,小林由美子,千葉紗子,水野愛日,皆川純子,ゆかな
戦場のヴァルキュリア	鹿野優以,桑島法子,進藤尚美,能登麻美子,三上枝織,皆川純子
結界師_(アニメ)	小笠原亜里沙,桑島法子,田中真弓,野沢雅子,藤田咲,本名陽子
ドラゴンボール改	佐々木智代,佐藤聡美,田中真弓,津田美波,野沢雅子,平野綾
プリンセスラバー!	遠藤綾,小野涼子,加藤英美里,松岡由貴,水原薫,三宅華也
超神姫ダンガイザー3	池澤春菜,井上喜久子,今井麻美,桑島法子,根谷美智子,堀江由衣
トワノクオン	小見川千明,寿美菜子,小林由美子,小松未可子,沼倉愛美,早見沙織
魔法騎士レイアース	井上喜久子,緒方恵美,笠原弘子,高山みなみ,千葉紗子,久川綾
HUNTER×HUNTER_(2011年のアニメ)	伊瀬茉莉也,工藤晴香,沢城みゆき,豊嶋真千子,潘恵子,平野綾
スーパードール★リカちゃん	大谷育江,櫻井智,竹内順子,根谷美智子,水田わさび
T.P.さくら_〜タイムパラディンさくら〜	竹達彩奈,新田恵海,藤田咲,三森すずこ,米澤円
閃光のナイトレイド	阿澄佳奈,遠藤綾,金元寿子,茅野愛衣,藤田咲
ジャンケンマン	田中真弓,松本梨香,三石琴乃,南央美,横山智佐
カスミン	金田朋子,釘宮理恵,根谷美智子,本田貴子,水橋かおり
アキハバラ電脳組	浅川悠,堀江由衣,本多知恵子,水田わさび,吉住梢
SDガンダムフォース	小林由美子,中川亜紀子,葉月絵理乃,久川綾,松来未祐
Prits	桑谷夏子,小林由美子,志村由美,水樹奈々,望月久代
放課後のプレアデス	大橋歩夕,桑島法子,高森奈津美,藤田咲,牧野由依
絶対少年	大浦冬華,甲斐田ゆき,清水愛,鈴木真仁,竹内順子
機動戦士ガンダム_クライマックスU.C.	能登麻美子,早水リサ,堀江由衣,水樹奈々,ゆかな
ネオ_アンジェリーク	浅倉杏美,池澤春菜,遠藤綾,永田依子,平田宏美
Mnemosyne-ムネモシュネの娘たち-	加藤英美里,釘宮理恵,園崎未恵,生天目仁美,能登麻美子
聖闘士星矢	折笠富美子,潘恵子,水原薫,山田栄子,吉田仁美
ファンタジックチルドレン	甲斐田ゆき,坂本真綾,進藤尚美,天神有海,皆川純子
AVENGER	有島モユ,島本須美,千葉紗子,恒松あゆみ,潘恵子
アニメがんばれゴエモン	佐久間紅美,丹下桜,根谷美智子,氷上恭子,久川綾
マシュマロ通信	植田佳奈,下屋則子,根本圭子,野沢雅子,福圓美里
ブレイク_ブレイド	浅野真澄,甲斐田裕子,花澤香菜,松嵜麗,森谷里美
クラッシュギアNitro	浅川悠,神田朱未,根谷美智子,本田貴子,ゆかな
ティーン・タイタンズ_(アニメ)	菊地ゆうみ,桑谷夏子,恒松あゆみ,根本圭子,三宅華也
プリンセス・プリンセス_(漫画)	小林ゆう,新谷良子,竹内順子,早水リサ,本田貴子
ガルフォース	井上喜久子,氷上恭子,本多知恵子,三石琴乃,横山智佐
デジモンテイマーズ	折笠富美子,金田朋子,サエキトモ,野沢雅子,三石琴乃
SHADOW_SKILL	大谷育江,加藤奈々絵,根谷美智子,氷上恭子,本多知恵子
ひだまりラジオ	阿澄佳奈,小見川千明,後藤邑子,新谷良子,水橋かおり
デビルマンレディー	岩男潤子,小笠原亜里沙,緒方恵美,田村ゆかり,皆口裕子
妄想科学シリーズ_ワンダバスタイル	植田佳奈,岡村明美,清水愛,中原麻衣,森永理科
魍魎の匣	鹿野優以,桑島法子,久川綾,本田貴子,皆口裕子
ブラック・ジャック_(OVA)	折笠富美子,工藤晴香,坂本真綾,潘恵子,氷上恭子
ドラゴンドライブ	岡村明美,サエキトモ,松来未祐,松本梨香,ゆかな
モンスターファーム_(アニメ)	折笠富美子,高山みなみ,潘恵子,三石琴乃,横山智佐
トップをねらえ!	千葉千恵巳,恒松あゆみ,日高のり子,福井裕佳梨,牧野由依
魔物ハンター妖子	島本須美,久川綾,日高のり子,本多知恵子,皆口裕子
冒険遊記プラスターワールド	浅川悠,神田理江,櫻井浩美,恒松あゆみ,松来未祐
G-onらいだーす	浅野真澄,釘宮理恵,田村ゆかり,水橋かおり,南央美
万能文化猫娘	根谷美智子,久川綾,三石琴乃,山崎和佳奈,渡辺久美子
星界の戦旗	浅井清己,大谷育江,甲斐田裕子,佐久間紅美,清水香里
陸上防衛隊まおちゃん	今井麻美,門脇舞以,豊嶋真千子,堀江由衣,皆川純子
愛してるぜベイベ★★	伊瀬茉莉也,大浦冬華,鈴木真仁,千葉紗子,悠木碧
今、そこにいる僕	岡村明美,齋藤彩夏,サエキトモ,本田貴子,松本梨香
RAVE_(漫画)	有島モユ,真田アサミ,山崎和佳奈,ゆかな,力丸乃りこ
MEZZO_-メゾ-	岡村明美,野田順子,能登麻美子,福圓美里,松来未祐
Yes!プリキュア5	小清水亜美,竹内順子,本名陽子,水田わさび,ゆかな
コヨーテ_ラグタイムショー	新井里美,下屋則子,生天目仁美,広橋涼,水沢史絵
シュガーバニーズ	植田佳奈,神田朱未,小清水亜美,田村ゆかり,堀江由衣
ドッとKONIちゃん	大谷育江,竹内順子,田村ゆかり,三石琴乃,南央美
Cosmic_Baton_Girl_コメットさん☆	川田妙子,千葉紗子,天神有海,本多知恵子,松岡由貴
SPEED_GRAPHER	大橋歩夕,真堂圭,藤田咲,本田貴子,森永理科
中華一番!	大本眞基子,桑島法子,田中真弓,友永朱音,野田順子
劇場版_鋼の錬金術師_シャンバラを征く者	釘宮理恵,桑島法子,根谷美智子,水樹奈々,三石琴乃
ワンワンセレプー_それゆけ!徹之進	井ノ上奈々,大浦冬華,甲斐田ゆき,真堂圭,廣田詩夢
おちゃめなふたご_クレア学院物語	大谷育江,島本須美,潘恵子,日高のり子,南央美
マクロスF	井上喜久子,遠藤綾,桑島法子,坂本真綾,平野綾
アクアキッズ	桑谷夏子,小林由美子,早水リサ,福圓美里,又吉愛
もえたん	井口裕香,金田朋子,田村ゆかり,本多陽子,森永理科
ギャラリーフェイク	小野涼子,小林ゆう,清水香里,根谷美智子,氷上恭子
ゾイド_-ZOIDS-	大本眞基子,岡村明美,千葉千恵巳,日高のり子,渡辺久美子
トリコ	金田朋子,三瓶由布子,田野アサミ,藤井ゆきよ,水樹奈々
ソニックX	川田妙子,小林由美子,進藤尚美,日高のり子,広橋涼
セイバーマリオネット	浅川悠,井上喜久子,佐久間紅美,野田順子,氷上恭子
ドラゴンボール	甲斐田裕子,小林ゆう,田中真弓,野沢雅子,皆口裕子
ドラゴンボール_(アニメ)	島本須美,田中真弓,野沢雅子,本多知恵子,山田栄子
サムライガン	鹿野優以,清水香里,茅原実里,中原麻衣,氷上恭子
太陽の船_ソルビアンカ	岩男潤子,サエキトモ,根谷美智子,本田貴子,松本梨香
はれときどきぶた_(テレビアニメ)	田口宏子,水田わさび,三石琴乃,南央美,ゆかな
時空探偵ゲンシクン	大谷育江,おみむらまゆこ,水樹奈々,水野愛日,ゆかな
いつだってMyサンタ!	小林ゆう,櫻井智,田村ゆかり,千葉紗子,平野綾
ふぉうちゅんドッグす	釘宮理恵,小林由美子,中川亜紀子,福圓美里,松本梨香
花咲ける青少年	浅倉杏美,新井里美,遠藤綾,甲斐田裕子,松来未祐
True_tears_(アニメ)	井口裕香,佐藤聡美,下田麻美,高垣彩陽,高橋理恵子
お伽草子_(アニメ)	小野涼子,佐久間紅美,早水リサ,水沢史絵,水田わさび
きまぐれオレンジ☆ロード	櫻井智,潘恵子,本多知恵子,皆口裕子,山田栄子
ポポロクロイス_(アニメ)	大谷育江,金田朋子,根谷美智子,皆口裕子,南央美
パンプキン・シザーズ	植田佳奈,加藤英美里,儀武ゆう子,恒松あゆみ,三宅華也
NIGHT_HEAD_GENESIS	鹿野優以,阪田佳代,真堂圭,仙台エリ,森永理科
マシュランボー	今野宏美,高山みなみ,潘恵子,久川綾,皆口裕子
CHAOS;HEAD	浅倉杏美,加藤英美里,真堂圭,友永朱音,生天目仁美
守り人シリーズ	下田麻美,進藤尚美,広橋涼,福圓美里,水田わさび
モノノ怪	池澤春菜,折笠富美子,桑島法子,山崎和佳奈,ゆかな
羊でおやすみシリーズ	井上喜久子,甲斐田ゆき,釘宮理恵,田村ゆかり,皆川純子
世界名作童話シリーズ_ワ〜ォ!メルヘン王国	井上喜久子,大谷育江,高山みなみ,久川綾,山崎和佳奈
姫ちゃんのリボン	井上喜久子,大谷育江,岡村明美,高山みなみ,横山智佐
宇宙戦艦ヤマト	井上喜久子,岩男潤子,潘恵子,久川綾,三石琴乃
臣士魔法劇場_リスキー☆セフティ	井上喜久子,おみむらまゆこ,坂本真綾,氷上恭子,堀江由衣
ゆとりちゃん	井上喜久子,沖佳苗,花澤香菜,藤村歩,悠木碧
魔法使いTai!	飯塚雅弓,岩男潤子,加藤奈々絵,天神有海,吉住梢
トランスフォーマー_ギャラクシーフォース	加藤奈々絵,桑島法子,桑谷夏子,豊嶋真千子,森永理科
聖闘士星矢_冥王ハーデス編	折笠富美子,鹿野優以,坂本真綾,豊嶋真千子,潘恵子
破邪巨星Gダンガイオー	浅野真澄,植田佳奈,水野愛日,皆口裕子,山本麻里安
ジーンシャフト	浅井清己,甲斐田裕子,桑島法子,坂本真綾,吉住梢
ベターマン	岩男潤子,桑島法子,天神有海,氷上恭子,皆口裕子
サクラ大戦_ニューヨーク・紐育	今野宏美,齋藤彩夏,園崎未恵,本名陽子,皆川純子
宇宙海賊ミトの大冒険	浅川悠,小林由美子,千葉千恵巳,豊嶋真千子,南央美
獣装機攻ダンクーガノヴァ	池澤春菜,桑島法子,後藤邑子,根谷美智子,美名
ぺとぺとさん	植田佳奈,儀武ゆう子,桑谷夏子,新谷良子,野田順子
美味しんぼ	島本須美,高山みなみ,潘恵子,山田栄子,横山智佐
ガンパレード・マーチ_〜新たなる行軍歌〜	岡村明美,甲斐田裕子,進藤尚美,野田順子,能登麻美子
キャシャーン_Sins	秋谷智子,沖佳苗,川田妙子,鈴木真仁,皆口裕子
スパイラル_〜推理の絆〜	浅野真澄,中原麻衣,氷上恭子,堀江由衣,三石琴乃
こすぷれCOMPLEX	浅野真澄,井上喜久子,釘宮理恵,清水愛,千葉紗子
低俗霊DAYDREAM	浅野真澄,岡村明美,田村ゆかり,根谷美智子,水橋かおり
BLUE_DROP	遠藤綾,後藤邑子,沢城みゆき,茅原実里,生天目仁美
まかせてイルか!	齋藤彩夏,三瓶由布子,清水香里,鈴木真仁,山本麻里安
星の海のアムリ	金田朋子,能登麻美子,平野綾,牧野由依,松本まりか
かってに改蔵	明坂聡美,岩男潤子,新谷良子,永田依子,堀江由衣
陰からマモル!	金田朋子,清水愛,新谷良子,豊嶋真千子,中原麻衣
爆球Hit!_クラッシュビーダマン	大浦冬華,神田朱未,福圓美里,水原薫,森永理科
電脳戦隊ヴギィ'ズ★エンジェル	井上喜久子,丹下桜,中川亜紀子,久川綾,三石琴乃
大魔法峠	齋藤彩夏,下屋則子,千葉紗子,能登麻美子,花澤香菜
大江戸ロケット	小笠原亜里沙,釘宮理恵,櫻井智,真堂圭,早水リサ
リーンの翼	甲斐田裕子,加藤英美里,阪田佳代,堀江由衣,皆川純子
ハーメルンのバイオリン弾き	飯塚雅弓,緒方恵美,島本須美,丹下桜,横山智佐
少女革命ウテナ	久川綾,日高のり子,本多知恵子,三石琴乃,渡辺久美子
宇宙ショーへようこそ	恒松あゆみ,永田依子,日高のり子,平田宏美,MAKO
魔女っ娘つくねちゃん	浅川悠,榎本温子,三瓶由布子,千葉千恵巳,桃井はるこ
レベルE	明坂聡美,小林ゆう,松嵜麗,森谷里美,吉田聖子
紅_(小説)	植田佳奈,真田アサミ,沢城みゆき,新谷良子,悠木碧
陽だまりの樹	折笠富美子,島本須美,根谷美智子,松本梨香,三石琴乃
無人惑星サヴァイヴ	浅井清己,岡村明美,小暮英麻,氷上恭子,皆川純子
機巧奇傳ヒヲウ戦記	池澤春菜,緒方恵美,桑島法子,水橋かおり,南央美
天使な小生意気	浅川悠,大本眞基子,豊嶋真千子,福井裕佳梨,渡辺久美子
あずきちゃん	川田妙子,潘恵子,松本梨香,皆口裕子,ゆかな
スカルマン	井上喜久子,折笠富美子,門脇舞以,根谷美智子,森永理科
ザ・サード	進藤尚美,生天目仁美,根谷美智子,日高のり子,松来未祐
ウエルベールの物語_〜Sisters_of_Wellber〜	甲斐田ゆき,仙台エリ,竹内順子,茅原実里,友永朱音
これが私の御主人様	浅野真澄,植田佳奈,桑谷夏子,清水愛,皆川純子
YAT安心!宇宙旅行	井上喜久子,田中真弓,丹下桜,水田わさび,渡辺久美子
Sci-Fi_HARRY	金田朋子,佐久間紅美,千葉紗子,堀江由衣,ゆかな
快傑蒸気探偵団	田口宏子,中島沙樹,根谷美智子,堀江由衣,横山智佐
ラブ★コン	岡村明美,早水リサ,氷上恭子,松岡由貴,米澤円
怪盗セイント・テール	井上喜久子,岩男潤子,櫻井智,根谷美智子,渡辺久美子
遊☆戯☆王ZEXAL	國立幸,小林ゆう,小松未可子,三瓶由布子,持月玲依
BRAVE10	浅川悠,井上喜久子,植田佳奈,橘田いずみ,津田美波
狼と香辛料	小清水亜美,後藤邑子,千葉紗子,中島沙樹,中原麻衣
おくさまは女子高生	遠藤綾,大浦冬華,桑谷夏子,茅原実里,松来未祐
TOKKO_特公	植田佳奈,遠藤綾,折笠富美子,門脇舞以,神田朱未
RED_GARDEN	寿美菜子,沢城みゆき,新谷良子,福圓美里,南央美
イリヤの空、UFOの夏	鹿野優以,儀武ゆう子,桑島法子,千葉紗子,広橋涼
遊☆戯☆王5D's	岡村明美,國立幸,寺崎裕香,皆川純子,吉田仁美
機動戦士ガンダムUC	伊瀬茉莉也,甲斐田裕子,田村睦心,広橋涼,藤村歩
機動戦士ガンダム	桑島法子,潘恵子,本多知恵子,水橋かおり,皆川純子
サクラ大戦TV	岡村明美,小林由美子,田中真弓,氷上恭子,横山智佐
よばれてとびでて!アクビちゃん	井上喜久子,神田朱未,桑谷夏子,小林由美子,松岡由貴
化物語	井口裕香,加藤英美里,沢城みゆき,花澤香菜,堀江由衣
HELLSING	折笠富美子,甲斐田裕子,坂本真綾,早水リサ,水橋かおり
CLUSTER_EDGE	桑島法子,能登麻美子,広橋涼,本名陽子
GANTZ	小林由美子,園崎未恵,生天目仁美,藤田咲
エックスメン_(2011年のアニメ)	岡村明美,田村ゆかり,久川綾,藤村歩
バットマン:_ブレイブ_&_ボールド	榎本温子,恒松あゆみ,根本圭子,早水リサ
ベルセルク_(漫画)	後藤邑子,寿美菜子,島本須美,高山みなみ
真マジンガー_衝撃!_Z編	藤田咲,藤村歩,本多陽子,牧口真幸
遙かなる時空の中で3	浅川悠,遠藤綾,大谷育江,桑島法子
プラネテス	桑島法子,小林ゆう,清水香里,渡辺久美子
HUNTER×HUNTER_(1999年のアニメ)	伊瀬茉莉也,甲斐田ゆき,竹内順子,天神有海
BLACK_BLOOD_BROTHERS	植田佳奈,佐久間紅美,沢城みゆき,南央美
グレネーダー	佐久間紅美,本多知恵子,松岡由貴,水橋かおり
月詠	門脇舞以,根谷美智子,松来未祐,山崎バニラ
宇宙の騎士テッカマンブレード	本多知恵子,松本梨香,横山智佐,渡辺久美子
砂沙美☆魔法少女クラブ	加藤英美里,門脇舞以,小暮英麻,仙台エリ
21エモン	大谷育江,潘恵子,久川綾,横山智佐
EAT-MAN	島本須美,高山みなみ,根谷美智子,久川綾
十兵衛ちゃん	齋藤彩夏,三瓶由布子,鈴木真仁,堀江由衣
GOLDEN_BOY	井上喜久子,岩男潤子,根谷美智子,皆口裕子
NOIR	神田理江,桑島法子,久川綾,三石琴乃
わたしとわたし_ふたりのロッテ	大谷育江,川田妙子,潘恵子,山崎和佳奈
ガングレイヴ	井上喜久子,佐久間紅美,高山みなみ,根谷美智子
ティーンエイジ・ミュータント・ニンジャ・タートルズ	池澤春菜,岩男潤子,恒松あゆみ,野沢雅子
こぴはん	大久保瑠美,下田麻美,長谷川明子,松嵜麗
八雲立つ	浅川悠,岡村明美,佐久間紅美,櫻井智
地球へ…	高垣彩陽,野田順子,水沢史絵,ゆかな
巌窟王_(テレビアニメ)	井上喜久子,遠藤綾,中原麻衣,渡辺久美子
BUZZER_BEATER	浅川悠,飯塚雅弓,千葉紗子,本田貴子
大工の源さん	桑島法子,小林由美子,根谷美智子,皆川純子
フォトン_(OVA)	浅川悠,竹内順子,堀江由衣,吉住梢
スウィート・ヴァレリアン	浅川悠,小清水亜美,三瓶由布子,千葉千恵巳
機動戦艦ナデシコ	大谷育江,桑島法子,南央美,横山智佐
喰霊	茅原実里,中村知子,福圓美里,水原薫
スーパーフィッシング_グランダー武蔵	大谷育江,天神有海,野田順子,横山智佐
あぃまぃみぃ!ストロベリー・エッグ	折笠富美子,甲斐田裕子,島本須美,南央美
ハローキティ_りんごの森シリーズ	釘宮理恵,沢城みゆき,三瓶由布子,平野綾
イヴの時間	榎本温子,沢城みゆき,三瓶由布子,ゆかな
おもいっきり科学アドベンチャー_そーなんだ!	釘宮理恵,根谷美智子,水田わさび,皆川純子
キン肉マンII世	折笠富美子,中川亜紀子,野田順子,広橋涼
スクライド	桜咲千依,大本眞基子,田村ゆかり,渡辺久美子
BLUE_SEED	岩男潤子,大谷育江,氷上恭子,三石琴乃
Master_of_Epic_The_Animation_Age	井ノ上奈々,笠原弘子,金田朋子,田中真弓
パパのいうことを聞きなさい!	赤崎千夏,上坂すみれ,氷上恭子,堀江由衣
闘魔鬼神伝ONI	井上喜久子,大谷育江,岡村明美,氷上恭子
魔法少女隊アルス	桑島法子,小林由美子,広橋涼,藤井ゆき
好きなものは好きだからしょうがない!!	大本眞基子,小林ゆう,恒松あゆみ,根本圭子
電光超特急ヒカリアン	サエキトモ,真田アサミ,西沢広香,力丸乃りこ
劇場版_遙かなる時空の中で_舞一夜	浅川悠,大谷育江,桑島法子,平田宏美
ファイ・ブレイン_神のパズル	清水香里,高森奈津美,竹達彩奈,ゆかな
ボイスオーバー	大本眞基子,小野涼子,友永朱音,中島沙樹
マジンカイザーSKL	浅野真澄,井上喜久子,清水愛,早見沙織
快傑ゾロ_(アニメ)	井上喜久子,大谷育江,松本梨香,三石琴乃
シックス・エンジェルズ	岡村明美,折笠富美子,根谷美智子,野田順子
超者ライディーン	大谷育江,岡村明美,根谷美智子,南央美
エイリアン9	三瓶由布子,下屋則子,清水香里,久川綾
えいがでとーじょー!_たまごっち_ドキドキ!_うちゅーのまいごっち!?	加藤奈々絵,儀武ゆう子,釘宮理恵,下屋則子
H2O_-FOOTPRINTS_IN_THE_SAND-	加藤英美里,小清水亜美,櫻井浩美,本多陽子
ななついろ★ドロップス	釘宮理恵,清水香里,生天目仁美,松岡由貴
がんばれ!キッカーズ	大谷育江,田中真弓,本多知恵子,山田栄子
赤ちゃんと僕	岡村明美,川田妙子,田中真弓,根谷美智子
獣兵衛忍風帖	桑島法子,久川綾,松本梨香,水樹奈々
NHKにようこそ!	岩男潤子,沢城みゆき,早水リサ,牧野由依
星方武侠アウトロースター	サエキトモ,久川綾,松本梨香,山崎和佳奈
マージナルプリンス〜月桂樹の王子達〜	岩男潤子,小野涼子,真堂圭,福圓美里
しあわせソウのオコジョさん	加藤奈々絵,沢城みゆき,竹内順子,山崎バニラ
花さか天使テンテンくん	浅川悠,甲斐田ゆき,天神有海,中川亜紀子
LEMON_ANGEL_PROJECT	門脇舞以,小清水亜美,清水香里,茅原実里
エクセル・サーガ	小林由美子,久川綾,三石琴乃,南央美
いばらの王	甲斐田裕子,仙台エリ,友永朱音,花澤香菜
リコーダーとランドセル	内田彩,釘宮理恵,合田彩,平野綾
交響詩篇エウレカセブン_ポケットが虹でいっぱい	小清水亜美,三瓶由布子,根谷美智子,水沢史絵
ウィンターガーデン	加藤英美里,真田アサミ,沢城みゆき,氷上恭子
鋼鉄神ジーグ	植田佳奈,岡村明美,友永朱音,野田順子
スター・ウォーズ/クローン・ウォーズ_(テレビアニメ)	甲斐田裕子,小清水亜美,坂本真綾,本田貴子
うちの3姉妹	大谷育江,川田妙子,津田美波,中村知子
ファイアーエムブレム_紋章の謎_(OVA)	島本須美,丹下桜,豊嶋真千子,根谷美智子
農業ムスメ!	真堂圭,廣田詩夢,三上枝織,水原薫
RD_潜脳調査室	大谷育江,沖佳苗,工藤晴香,三石琴乃
Witch_Hunter_ROBIN	神田朱未,後藤邑子,氷上恭子,牧島有希
バトルアスリーテス_大運動会	岡村明美,川田妙子,田村ゆかり,久川綾
京騒戯画	釘宮理恵,原嶋あかり,久川綾,日高のり子
恋風	明坂聡美,岡村明美,折笠富美子,松来未祐
プロダクション・エース演技研究所	合田彩,富樫美鈴,野水伊織,本多真梨子
ボンバーマンジェッターズ	金田朋子,小林由美子,竹内順子,松本梨香
ファーブル先生は名探偵	有島モユ,大本眞基子,甲斐田ゆき,根谷美智子
星のカービィ_(アニメ)	大本眞基子,神田朱未,高山みなみ,渡辺久美子
フォーチュン・クエストL	浅川悠,中川亜紀子,根谷美智子,南央美
プリンセスナイン_如月女子高野球部	飯塚雅弓,川田妙子,島本須美,氷上恭子
まじかる☆タルるートくん	高山みなみ,野沢雅子,能登麻美子,本多知恵子
チーズスイートホーム	桑島法子,中村知子,日高のり子,松本梨香
ロスト・ユニバース	大本眞基子,鈴木真仁,根谷美智子,野田順子
幕末機関説_いろはにほへと	大本眞基子,進藤尚美,園崎未恵,松岡由貴
強殖装甲ガイバー	根谷美智子,本多知恵子,松来未祐,水樹奈々
無敵王トライゼノン	金田朋子,真田アサミ,田村ゆかり,根谷美智子
爆闘宣言ダイガンダー	甲斐田ゆき,神田理江,坂本真綾,野沢雅子
ロビーとケロビー	金田朋子,儀武ゆう子,下田麻美,水田わさび
神八剣伝	浅川悠,鈴木真仁,天神有海,水樹奈々
遙かなる時空の中で-八葉抄-	浅川悠,大谷育江,桑島法子,久川綾
魔法戦士リウイ	井上喜久子,折笠富美子,高山みなみ,松来未祐
魁!!クロマティ高校	加藤奈々絵,齋藤彩夏,真田アサミ,沢城みゆき
ヨスガノソラ	小野涼子,阪田佳代,田口宏子,氷上恭子
風まかせ月影蘭	岩男潤子,岡村明美,水橋かおり,りの
アニメイトモバイルシリーズ	阿澄佳奈,竹達彩奈,巽悠衣子,牧野由依
ゆるめいつ	桑谷夏子,竹達彩奈,松来未祐,桃井はるこ
カリメロ	岡村明美,笠原弘子,野沢雅子,松本梨香
AIKa_R-16:VIRGIN_MISSION	小清水亜美,阪田佳代,能登麻美子,福圓美里
最終兵器彼女	浅井清己,折笠富美子,今野宏美,中原麻衣
DTエイトロン	中川亜紀子,根谷美智子,久川綾,ゆかな
NO.6	真堂圭,高垣彩陽,恒松あゆみ,安野希世乃
ドージンワーク	浅野真澄,門脇舞以,儀武ゆう子,長谷優里奈
GALS!	池澤春菜,壱智村小真,釘宮理恵,氷上恭子
マクロス_ゼロ	進藤尚美,高山みなみ,南里侑香,広橋涼
IZUMO_-猛き剣の閃記-	壱智村小真,井ノ上奈々,儀武ゆう子,力丸乃りこ
ロミオの青い空	岡村明美,笠原弘子,丹下桜,野田順子
真月譚_月姫	植田佳奈,折笠富美子,生天目仁美,根本圭子
BB戦士三国伝	金元寿子,神田朱未,田村睦心,恒松あゆみ
ヒゲぴよ	新井里美,金田朋子,小林ゆう,中村知子
風の中の少女_金髪のジェニー	川田妙子,島本須美,南央美,渡辺久美子
VIPER'S_CREED	植田佳奈,甲斐田ゆき,皆川純子,山本麻里安
落語天女おゆい	小林ゆう,沢城みゆき,清水愛,野田順子
ぼのぼの	島本須美,田中真弓,潘恵子,渡辺久美子
マクロス7	岩男潤子,櫻井智,中川亜紀子,ゆかな
精霊使い	岩男潤子,高山みなみ,皆口裕子,山崎和佳奈
よみがえる空_-RESCUE_WINGS-	大本眞基子,仙台エリ,能登麻美子,早水リサ
SHUFFLE!_(アニメ)	後藤邑子,真堂圭,藤田咲,米澤円
Project_BLUE_地球SOS	野田順子,広橋涼,本田貴子,水沢史絵
幽幻怪社	丹下桜,久川綾,松本梨香,三石琴乃
ガイキング_LEGEND_OF_DAIKU-MARYU	池澤春菜,進藤尚美,田中真弓,豊嶋真千子
あさっての方向。	儀武ゆう子,小清水亜美,坂本梓馬,藤村歩
C_(アニメ)	儀武ゆう子,田村睦心,中村知子,牧野由依
きらめき☆プロジェクト	門脇舞以,金田朋子,釘宮理恵,根谷美智子
シャングリ・ラ_(池上永一の小説)	井口裕香,金田朋子,望月久代,渡辺久美子
ネットゴーストPIPOPA	新井里美,儀武ゆう子,清水香里,高垣彩陽
デジモンアドベンチャー	壱智村小真,折笠富美子,竹内順子,天神有海
奏光のストレイン	阪田佳代,松来未祐,皆川純子,ゆかな
世界名作劇場	三瓶由布子,島本須美,潘恵子,山田栄子
ダンボール戦機	岡村明美,真堂圭,中村知子,藤東知夏
クリスタル_ブレイズ	新井里美,小林ゆう,沢城みゆき,千葉紗子
LOVE_×_HEAVEN	伊瀬茉莉也,釘宮理恵,小清水亜美,中原麻衣
機動戦士Ζガンダム	浅川悠,新井里美,潘恵子,ゆかな
模型戦士ガンプラビルダーズ_ビギニングG	伊瀬茉莉也,遠藤綾,金元寿子,田村睦心
スターオーシャンEX	飯塚雅弓,折笠富美子,小暮英麻,松本梨香
B'T-X	緒方恵美,氷上恭子,日高のり子,横山智佐
Dororonえん魔くん_メ〜ラめら	井上喜久子,野沢雅子,能登麻美子,日高のり子
蒼天航路	井上喜久子,遠藤綾,桑島法子,葉月絵理乃
へうげもの	小笠原亜里沙,儀武ゆう子,牧口真幸,山本麻里安
スーパーロボット大戦OG_-ディバイン・ウォーズ-	岩男潤子,小林由美子,佐久間紅美,平井理子
人造人間キカイダー_THE_ANIMATION	小林由美子,高山みなみ,氷上恭子,堀江由衣
天空のエスカフローネ	飯塚雅弓,大谷育江,坂本真綾,高山みなみ
闇の末裔	佐久間紅美,高山みなみ,豊嶋真千子,水田わさび
つよきす〜Cool×Sweet〜コンプリートセレクション	小林ゆう,中原麻衣,藤田咲,水樹奈々
ケロケロちゃいむ	笠原弘子,鈴木真仁,竹内順子,田中真弓
Candy☆Boy	加藤英美里,小林ゆう,生天目仁美
アキカン!	能登麻美子,広橋涼,悠木碧
SPACE_PIRATE_CAPTAIN_HERLOCK	折笠富美子,高山みなみ,皆口裕子
サルゲッチュ_(アニメ)	小林由美子,竹内順子,皆川純子
Paradise_Kiss	釘宮理恵,松本まりか,松本梨香
それいけ!アンパンマン_人魚姫のなみだ	岩男潤子,島本須美,潘恵子
電影少女	高山みなみ,根谷美智子,三石琴乃
エレメントハンター	榎本温子,桑島法子,山本麻里安
星に願いを_(アニメ作品)	加藤英美里,沢城みゆき,氷上恭子
超ロボット生命体トランスフォーマー_マイクロン伝説	甲斐田裕子,神田理江,広橋涼
よなよなペンギン	桑島法子,松本梨香,皆口裕子
電脳冒険記ウェブダイバー	甲斐田ゆき,小林由美子,竹内順子
HEROMAN	小笠原亜里沙,小松未可子,進藤尚美
RAINBOW-二舎六房の七人-	桑島法子,津田美波,早水リサ
ひとひら	植田佳奈,恒松あゆみ,氷上恭子
獣神演武	折笠富美子,甲斐田裕子,神田朱未
うさぎちゃんでCue!!	浅井清己,佐久間紅美,根谷美智子
ふたつのスピカ	大浦冬華,甲斐田ゆき,笠原弘子
花の魔法使いマリーベル	島本須美,本多知恵子,三石琴乃
超音戦士ボーグマン	大谷育江,ゆかな,渡辺久美子
めぞん一刻_(アニメ)	大谷育江,島本須美,渡辺久美子
ヱデンズボゥイ	水橋かおり,山崎和佳奈,吉住梢
ウルヴァリン_(アニメ)	折笠富美子,福圓美里,水沢史絵
秘境探検ファム&イーリー	井上喜久子,根谷美智子,松本梨香
ねとらん者_THE_MOVIE	榎本温子,平井理子,桃井はるこ
ウェディングピーチDX	氷上恭子,三石琴乃,ゆかな
蒼い海のトリスティア	千葉紗子,友永朱音,皆川純子
涼風_(漫画)	明坂聡美,甲斐田ゆき,鈴木真仁
銀河戦国群雄伝ライ	緒方恵美,三石琴乃,山田栄子
Bビーダマン爆外伝	川田妙子,桑島法子,松本梨香
棺担ぎのクロ。〜懐中旅話〜	高山みなみ,能登麻美子,久川綾
GS美神_極楽大作戦!!	緒方恵美,皆口裕子,山崎和佳奈
ONE_PIECE_ねじまき島の冒険	岡村明美,島本須美,田中真弓
THE_ビッグオー	池澤春菜,田村ゆかり,水橋かおり
お〜い!竜馬	井上喜久子,島本須美,高山みなみ
それいけ!アンパンマン_ばいきんまんの逆襲	島本須美,田中真弓,日高のり子
キョロちゃん_(アニメ)	釘宮理恵,野田順子,本田貴子
ゾイドフューザーズ	恒松あゆみ,生天目仁美,水野愛日
バジリスク_〜甲賀忍法帖〜	沢城みゆき,早水リサ,水樹奈々
バットマン_(アニメ)	井上喜久子,高山みなみ,松本梨香
エリアス_ちいさなレスキューせん	池澤春菜,甲斐田ゆき,園崎未恵
マドレーヌ_(アニメ)	大谷育江,島本須美,望月久代
クロスファイト_ビーダマン	甲斐田ゆき,國立幸,清水愛
太陽の子エステバン	池澤春菜,野沢雅子,潘恵子
東京BABYLON	島本須美,根谷美智子,福井裕佳梨
川の光	折笠富美子,金田朋子,平野綾
忍者戦士飛影	島本須美,日高のり子,山田栄子
新釈_眞田十勇士	折笠富美子,三石琴乃,三宅華也
サクラ大戦_ル・ヌーヴォー・巴里	井上喜久子,大浦冬華,日高のり子
科学忍者隊ガッチャマン	根谷美智子,野沢雅子,松本梨香
キャンディ・キャンディ	栗林みな実,野沢雅子,山田栄子
超電動ロボ_鉄人28号FX	岡村明美,高山みなみ,山崎和佳奈
フイチンさん	葉月絵理乃,松来未祐,山崎バニラ
ルーンエンジェル隊	明坂聡美,稲村優奈,平野綾
装甲騎兵ボトムズ_Case;IRVINE	荒浪和沙,遠藤綾,悠木碧
特務戦隊シャインズマン	笠原弘子,日高のり子,松本梨香
Dr.スランプ_アラレちゃん	田中真弓,潘恵子,山田栄子
最終神話戦争イデアオペラ	甲斐田裕子,生天目仁美,水田わさび
サムライチャンプルー	生天目仁美,日高のり子,福圓美里
タイムボカン2000_怪盗きらめきマン	浅野真澄,岡村明美,小林由美子
ヤットデタマン	田中真弓,潘恵子,山田栄子
リトルフット	大谷育江,高山みなみ,松本梨香
BLUE_GENDER	金田朋子,桑島法子,進藤尚美
NieA_7	折笠富美子,能登麻美子,山本麻里安
風の少女エミリー	榎本温子,岡村明美,久川綾
フリクリ	三瓶由布子,千葉千恵巳,福井裕佳梨
チロリン村物語	川田妙子,高山みなみ,日高のり子
THE八犬伝	高山みなみ,日高のり子,本多知恵子
鉄のラジオバレル	植田佳奈,下屋則子,能登麻美子
セクシーコマンドー外伝_すごいよ!!マサルさん	齋藤彩夏,福井裕佳梨,南央美
練馬大根ブラザーズ	竹内順子,新名彩乃,松来未祐
イン・ヤン・ヨー!	狩野茉莉,本名陽子,米澤円
パピヨンローゼ	井上喜久子,綱掛裕美,山本麻里安
天体戦士サンレッド	桑谷夏子,皆口裕子,力丸乃りこ
機動新世紀ガンダムX	本多知恵子,三石琴乃,渡辺久美子
働きマン	沖佳苗,小野涼子,福圓美里
RIDEBACK	園崎未恵,早水リサ,水樹奈々
ニャニがニャンだー_ニャンダーかめん	川田妙子,小暮英麻,水田わさび
なるたる	真田アサミ,西沢広香,能登麻美子
夢のクレヨン王国	竹内順子,天神有海,松岡由貴
おねがい♪マイメロディ_きららっ★	橘田いずみ,沢城みゆき,竹内順子
図書館戦争	植田佳奈,沖佳苗,沢城みゆき
ケモノヅメ	儀武ゆう子,藤村歩,南央美
発明BOYカニパン	小林由美子,鈴木真仁,竹内順子
超発明BOYカニパン	小林由美子,坂本真綾,竹内順子
エリア88	田中真弓,広橋涼,山崎和佳奈
ガサラキ	高山みなみ,丹下桜,山崎和佳奈
タッチ_(漫画)	今井麻美,高山みなみ,日高のり子
R-15_(小説)	合田彩,月宮みどり,野水伊織
絢爛舞踏祭_ザ・マーズ・デイブレイク	折笠富美子,桑島法子,堀江由衣
地球防衛企業ダイ・ガード	釘宮理恵,田村ゆかり,根谷美智子
魔動王グランゾート	高山みなみ,久川綾,渡辺久美子
小公子セディ	高山みなみ,潘恵子,山田栄子
まめうしシリーズ	稲村優奈,下屋則子,望月久代
OH!MYコンブ	高山みなみ,横山智佐,渡辺久美子
Ef_-_a_fairy_tale_of_the_two.	田口宏子,田村睦心,原田ひとみ
全力ウサギ	牧口真幸,三石琴乃,皆川純子
メーテルレジェンド	榎本温子,進藤尚美,潘恵子
サクラ大戦_エコール・ド・巴里	井上喜久子,高山みなみ,日高のり子
獣神ライガー	田中真弓,本多知恵子,皆口裕子
アニメーション映画	寿美菜子,田村ゆかり,平野綾
戦慄のミラージュポケモン	飯塚雅弓,大谷育江,松本梨香
蜜×蜜ドロップス	神田理江,坂本梓馬,福圓美里
FREEDOM-PROJECT	小林由美子,仙台エリ,藤村歩
少女チャングムの夢	高橋理恵子,恒松あゆみ,友永朱音
青い瞳の女の子のお話	桑島法子,小林由美子,島本須美
チョコレート・アンダーグラウンド	秋谷智子,坂本真綾,水沢史絵
快感・フレーズ	榎本温子,久川綾,吉住梢
女神候補生	釘宮理恵,千葉千恵巳,皆口裕子
アニマル横町	大浦冬華,折笠富美子,加藤奈々絵
映画!_たまごっち_うちゅーいちハッピーな物語!?	儀武ゆう子,釘宮理恵,竹内順子
さきいか君	佐藤聡美,鈴木真仁,三上枝織
ももいろシスターズ	川田妙子,根谷美智子,能登麻美子
Soul_Link	井ノ上奈々,小林ゆう,佐久間紅美
ロケットガール	仙台エリ,豊嶋真千子,生天目仁美
ファイナルファンタジー_(OVA)	笠原弘子,松本梨香,皆口裕子
Serial_experiments_lain	清水香里,根谷美智子,水野愛日
ロードス島戦記-英雄騎士伝-	浅川悠,坂本真綾,野田順子
まみむめ★もがちょ	大本眞基子,今野宏美,水樹奈々
タイドライン・ブルー	栗林みな実,氷上恭子,本名陽子
機動戦士Vガンダム	松本梨香,横山智佐,渡辺久美子
MAICO2010	緒方恵美,おみむらまゆこ,丹下桜
009ノ1	小野涼子,甲斐田裕子,甲斐田ゆき
遙かなる時空の中で2-白き龍の神子-	浅川悠,大谷育江,桑島法子
ふたつの胡桃	金田朋子,松岡由貴,松本梨香
にゃんぱいあ	小清水亜美,後藤邑子,廣田詩夢
遙かなる時空の中で-紫陽花ゆめ語り-	浅川悠,大谷育江,桑島法子
火魅子伝	井上喜久子,氷上恭子,南央美
湾岸ミッドナイト	恒松あゆみ,能登麻美子,早水リサ
ヴァイス・サヴァイヴ	榎本温子,橘田いずみ,徳井青空
アイアンマン_(2010年のアニメ)	桑島法子,広橋涼,本田貴子
ザ・バットマン	浅川悠,藤村歩,本田貴子
ユメミル、アニメ「onちゃん」	大浦冬華,金田朋子,今野宏美
TOKYO_TRIBE2	小林ゆう,本田貴子,水沢史絵
ほしいもパラダイス_〜乾物を越えた愛〜	遠藤綾,能登麻美子,花澤香菜
装甲救助部隊レストル	池澤春菜,折笠富美子,皆口裕子
BASARA	大谷育江,園崎未恵,根谷美智子
ザ・リプレイス_大人とりかえ作戦	浅井清己,狩野茉莉,水田わさび
暗黒キャット	桑島法子,桑谷夏子,牧野由依
アーケードゲーマーふぶき	浅川悠,清水香里,根谷美智子
トランスフォーマー_アニメイテッド	明坂聡美,高垣彩陽,本田貴子
タイムパトロール隊オタスケマン	島本須美,潘恵子,山田栄子
シャーマニックプリンセス	櫻井智,中川亜紀子,松本梨香
南国少年パプワくん	大谷育江,田中真弓,南央美
サクラ大戦_桜華絢爛	岡村明美,田中真弓,氷上恭子
ダーティペア	島本須美,潘恵子,松本梨香
GIANT_KILLING	浅野真澄,儀武ゆう子,廣田詩夢
獣王星	高山みなみ,早水リサ,水樹奈々
モルダイバー	井上喜久子,松本梨香,ゆかな
伝心_まもって守護月天!	金田朋子,桑島法子,山崎和佳奈
ロボタン	田中真弓,潘恵子,山田栄子
黄金勇者ゴルドラン	大谷育江,南央美,山崎和佳奈
Gdgd妖精s	明坂聡美,水原薫,三森すずこ
ピーチガール	鹿野優以,佐久間紅美,千葉紗子
UYAMUYA	浅井清己,栗林みな実,吉住梢
すーぱーぞうさんず&Rice5	浅野真澄,神田朱未,堀江由衣
エイケン_(漫画)	浅野真澄,門脇舞以,新谷良子
妖しのセレス	岩男潤子,佐久間紅美,能登麻美子
Phantom_-PHANTOM_THE_ANIMATION-	井上喜久子,儀武ゆう子,南央美
魔法のステージファンシーララ	飯塚雅弓,根谷美智子,南央美
りぜるまいん	浅野真澄,釘宮理恵,清水愛
超獣機神ダンクーガ	笠原弘子,潘恵子,山田栄子
ホッタラケの島_〜遥と魔法の鏡〜	甲斐田裕子,沢城みゆき,広橋涼
機動戦士ガンダム戦記_Lost_War_Chronicles	浅野真澄,井上喜久子,仁後真耶子
タマ&フレンズ_探せ!魔法のプニプニストーン	小林由美子,新谷良子,皆川純子
ゾイドジェネシス	恒松あゆみ,根本圭子,平田宏美
サイレントメビウス	川田妙子,島本須美,本多知恵子
サイボーグクロちゃん	大本眞基子,田中真弓,綱掛裕美
デッドガールズ	沢城みゆき,新谷良子,福圓美里
サクラ大戦_轟華絢爛	岡村明美,田中真弓,氷上恭子
イース_(OVA)	高山みなみ,本多知恵子,三石琴乃
サクラ大戦_神崎すみれ_引退記念_す・み・れ	岡村明美,田中真弓,氷上恭子
雲界の迷宮ZEGUY	日高のり子,山田栄子,横山智佐
BRIGADOON_まりんとメラン	齋藤彩夏,田村ゆかり,水田わさび
バンパイヤン・キッズ	釘宮理恵,竹内順子,ゆかな
萌えCanちぇんじ!	大亀あすか,加藤英美里,新谷良子
バブルガムクライシス	笠原弘子,久川綾,横山智佐
SD☆Children	金田朋子,松来未祐,桃井はるこ
ふしぎの海のナディア	井上喜久子,門脇舞以,日高のり子
VS騎士ラムネ&40炎	根谷美智子,氷上恭子,横山智佐
ベルサイユのばら	井上喜久子,野沢雅子,潘恵子
スージー・ズー	坂本真綾,竹達彩奈,中原麻衣
それいけ!アンパンマン_ブラックノーズと魔法の歌	野沢雅子,潘恵子,牧口真幸
